"","date","observed_cumulative_cases","observed_active_cases","observed_cumulative_deaths","observed_new_cases","observed_daily_average_cases","observed_new_episodes","observed_new_cases_community_outbreak","observed_new_cases_institution_outbreak","observed_new_cases_sporadic","observed_new_ICU_p_acute_care","observed_census_ICU","observed_census_ICU_p_acute_care","observed_census_acute_care","observed_new_deaths","cumulative_hosp","observed_new_community_cases","num_non_ltch_tests","non_ltch_pct_positivity","num_ltch_tests","ltch_pct_positivity","observed_pct_positivity","pct_positivity_7_day","adjusted_new_episodes","adjusted_active_cases","adjusted_episode_cases"
"1",2020-03-01,7,7,0,0,0,2,0,0,2,0,0,1,1,0,0,2,NA,NA,NA,NA,NA,NA,NA,NA,2
"2",2020-03-02,10,10,0,0,0,3,2,0,1,0,0,1,1,0,0,3,NA,NA,NA,NA,NA,NA,NA,NA,3
"3",2020-03-03,11,11,0,0,0,1,0,0,1,0,0,1,1,0,0,1,NA,NA,NA,NA,NA,NA,NA,NA,1
"4",2020-03-04,12,12,0,0,0,1,0,0,1,0,0,1,1,0,0,1,NA,NA,NA,NA,NA,NA,NA,NA,1
"5",2020-03-05,18,17,0,0,0,6,2,0,4,0,0,1,1,0,0,6,NA,NA,NA,NA,NA,NA,NA,NA,6
"6",2020-03-06,23,22,0,0,0,5,0,1,4,0,0,1,1,0,0,4,NA,NA,NA,NA,NA,NA,NA,NA,5
"7",2020-03-07,27,26,0,0,0,4,0,0,4,0,0,1,1,0,0,4,NA,NA,NA,NA,NA,NA,NA,NA,4
"8",2020-03-08,36,35,0,0,0,9,1,0,8,0,0,1,1,0,0,9,NA,NA,NA,NA,NA,NA,NA,NA,9
"9",2020-03-09,45,44,0,1,0.1,9,0,0,9,0,0,1,1,0,0,9,NA,NA,NA,NA,NA,NA,NA,NA,9
"10",2020-03-10,52,51,0,0,0.1,7,1,0,6,0,0,1,1,0,0,7,NA,NA,NA,NA,NA,NA,NA,NA,7
"11",2020-03-11,61,60,0,0,0.1,9,0,0,9,0,0,1,1,0,0,9,NA,NA,NA,NA,NA,NA,NA,NA,9
"12",2020-03-12,75,74,0,3,0.6,14,1,0,13,0,0,1,1,0,0,14,NA,NA,NA,NA,NA,NA,NA,NA,14
"13",2020-03-13,97,96,0,1,0.7,22,2,2,18,0,0,1,1,0,0,20,NA,NA,NA,NA,NA,NA,NA,NA,22
"14",2020-03-14,115,114,0,4,1.3,18,1,1,16,1,0,2,2,0,1,17,NA,NA,NA,NA,NA,NA,NA,NA,18
"15",2020-03-15,142,140,0,4,1.9,27,1,0,26,0,0,2,2,0,1,27,NA,NA,NA,NA,NA,NA,NA,NA,27
"16",2020-03-16,157,155,0,0,1.7,15,0,0,15,0,0,2,2,0,1,15,NA,NA,NA,NA,NA,NA,NA,NA,15
"17",2020-03-17,180,177,0,5,2.4,23,1,0,22,2,0,4,4,0,3,23,127,0,4,0,0,0,23,177,23
"18",2020-03-18,196,192,0,4,3,16,0,0,16,0,0,3,3,0,3,16,210,0.0190499997138977,1,0,1.89597153550641,0.947985767753204,15.8470022846243,190.164027415491,16
"19",2020-03-19,221,217,0,1,2.7,25,0,0,25,4,0,7,7,0,7,25,110,0.0272699999809265,9,0,2.52075630075791,1.47224261208811,24.68216331656,214.241177587741,25
"20",2020-03-20,243,239,0,2,2.9,22,1,1,20,3,1,10,9,0,10,21,137,0.00730000019073486,4,0,0.709290798674238,1.28150465873464,21.9248763343839,238.14502113894,22
"21",2020-03-21,263,259,0,4,2.9,20,0,2,18,3,1,10,9,0,13,18,204,0.0147099995613098,3,0,1.44968111618705,1.31513995022512,19.8683932582968,257.106325216605,20
"22",2020-03-22,289,285,0,7,3.3,26,0,1,25,3,5,13,8,0,16,25,159,0.0314499998092651,2,0,3.10593165818208,1.61360523488462,25.6083798275418,280.535530033976,26
"23",2020-03-23,310,306,0,9,4.6,21,2,0,19,4,5,17,12,0,20,21,138,0.0362299990653992,3,0,3.54591480214545,1.88964945877902,20.6244387796971,300.527536504158,21
"24",2020-03-24,328,322,1,8,5,18,1,3,14,3,7,20,13,1,23,15,253,0.0197599995136261,4,0,1.94524508830638,2.16754161425136,17.8528369647254,318.840900176105,18
"25",2020-03-25,351,345,1,8,5.6,23,0,1,22,4,8,23,15,0,27,22,153,0.0588199996948242,2,0,5.80610319568265,2.7261318514194,22.3557705388154,334.897310722332,23
"26",2020-03-26,365,355,1,19,8.1,14,1,3,10,2,7,25,18,0,29,11,274,0.025550000667572,3,0,2.5273285858898,2.72707074929538,13.8597872378211,350.474951766046,14
"27",2020-03-27,382,363,1,27,11.7,17,3,2,12,5,9,26,17,0,34,15,577,0.0294600009918213,4,0,2.92571782655437,3.04370318184968,16.7786615587408,357.643609721528,17
"28",2020-03-28,407,385,2,26,14.9,25,1,1,23,3,8,25,17,1,37,24,367,0.0817399978637695,3,0,8.10772411243336,3.99485218131344,24.0186061001959,369.256806190642,25
"29",2020-03-29,426,397,2,11,15.4,19,5,4,10,7,8,31,23,0,44,15,184,0.0434800004959106,0,0,4.34800004959107,4.1722905229433,18.6710620741219,388.29410956176,19
"30",2020-03-30,451,407,3,48,21,25,8,3,14,4,12,32,20,1,48,22,549,0.0783199977874756,0,0,7.83199977874756,4.7845883767436,24.1309825493263,390.923177162536,25
"31",2020-03-31,468,404,3,51,27.1,17,2,3,12,6,13,34,21,0,54,14,943,0.064689998626709,0,0,6.4689998626709,5.43083905879567,16.5432292054143,390.81889992767,17
"32",2020-04-01,495,406,3,37,31.3,27,6,4,16,3,15,33,18,0,57,22,575,0.0573899984359741,4,0.25,5.87206374795943,5.44026199483521,25.3484517348567,393.975972925084,27
"33",2020-04-02,512,402,6,32,33.1,17,5,4,7,6,14,34,20,3,63,12,107,0.0841100025177002,9,0,7.75842264602924,6.1875611462837,15.5304435282129,386.269858195131,17
"34",2020-04-03,539,407,6,26,33,27,3,4,19,5,14,37,23,0,68,22,217,0.110600004196167,2,0,10.9589958495745,7.33517229242944,24.7840195474745,384.504361628278,27
"35",2020-04-04,556,415,7,18,31.9,17,3,7,6,7,14,43,29,1,75,9,315,0.0253999996185303,3,0,2.51603769806196,6.53635994751924,15.8857929789707,409.73378736365,17
"36",2020-04-05,583,426,8,40,36,27,4,8,13,4,13,43,30,1,79,17,422,0.0663500022888184,5,0.2,6.79149905524153,6.88543123404074,24.4176987582793,411.408215942763,27
"37",2020-04-06,602,426,9,40,34.9,19,3,7,9,4,12,44,32,1,83,12,238,0.117650003433228,4,0.25,11.9837606682265,7.47853993253773,18.2747169579639,400.252452007718,19
"38",2020-04-07,625,424,9,25,31.1,23,2,11,10,4,14,45,31,0,87,12,285,0.108769998550415,6,0,10.6527318167932,8.07621592598378,22.3552736947957,401.219670549447,23
"39",2020-04-08,645,427,11,26,29.6,20,1,10,8,5,16,44,28,2,92,9,368,0.0434800004959106,6,0.333330001831055,4.81300005173301,7.92492111223715,18.7815301421972,416.634818968688,20
"40",2020-04-09,681,435,11,25,28.6,36,1,20,13,6,16,47,31,0,98,14,295,0.0949199962615967,5,0,9.33379963239034,8.14997496743159,33.340948034457,414.522313927771,36
"41",2020-04-10,715,451,11,36,30,34,0,20,13,4,16,49,33,0,102,13,331,0.090629997253418,8,0,8.84912362562872,7.84856464972504,32.4198012818967,430.871567548877,34
"42",2020-04-11,759,481,11,31,31.9,44,0,34,8,5,19,53,34,0,107,8,225,0.102220001220703,11,0.363639984130859,11.4404830932617,9.12348542046786,41.5383981923558,453.246191315391,44
"43",2020-04-12,792,496,13,35,31.1,33,0,18,14,1,18,49,31,2,108,14,227,0.101319999694824,12,0.5,12.1337405567887,9.88666277783175,31.1432464935727,465.646447200861,33
"44",2020-04-13,816,503,16,16,27.7,24,0,19,5,3,20,51,31,3,111,5,165,0.0606099987030029,26,0.0384599995613098,5.75948155737672,8.99748004771035,23.8547598975768,488.388845696222,24
"45",2020-04-14,849,503,18,32,28.7,33,0,26,7,5,20,50,30,2,116,7,208,0.0673099994659424,18,0.166669998168945,7.52236276812258,8.55028446932883,32.7344260556733,483.916615143379,33
"46",2020-04-15,878,501,24,60,33.6,29,2,18,9,4,16,50,34,6,120,11,390,0.1,24,0.208330001831055,10.6280000106148,9.38099874916909,28.4103729739595,474.145169086703,29
"47",2020-04-16,948,550,24,21,33,70,1,55,13,7,13,52,39,0,127,14,310,0.0354800009727478,11,0,3.42641753942424,8.5370870216025,68.7580634572128,540.49535010479,70
"48",2020-04-17,980,554,26,73,38.3,32,0,26,6,0,13,49,36,2,127,6,378,0.0846599960327148,66,0.5,14.6399726352176,9.36435116582949,31.5569786404218,513.094361132275,32
"49",2020-04-18,1020,576,31,31,38.3,40,0,31,9,1,11,46,35,5,128,9,421,0.0617600011825562,8,0,6.06082995288022,8.59582928863213,39.7248891245085,558.392903968544,40
"50",2020-04-19,1037,579,35,38,38.7,17,0,13,4,5,15,47,32,4,133,4,452,0.0442500019073486,47,0.127659997940063,5.21062540386865,7.60681283821498,16.8948805707864,563.783962621334,17
"51",2020-04-20,1098,615,39,16,38.7,61,1,47,13,3,13,45,32,4,136,14,325,0.0523099994659424,43,0.0232599997520447,4.89155701515467,7.48282361789754,60.6546111559738,599.827561494564,61
"52",2020-04-21,1134,628,47,51,41.4,36,0,26,10,2,11,43,32,8,138,10,543,0.069980001449585,25,0.36,8.27449661745152,7.59027131065882,35.5826746820015,601.791970029694,36
"53",2020-04-22,1175,645,54,35,37.9,41,1,31,9,4,9,45,36,7,142,10,656,0.0243899989128113,122,0.106560001373291,3.7275269221524,6.60448944087848,40.8120016926644,632.874109176852,41
"54",2020-04-23,1220,660,57,50,42,45,0,35,10,5,11,48,37,3,147,10,775,0.0361299991607666,105,0.0285700011253357,3.522795394063,6.61825770582687,44.8223273540326,648.273605366151,45
"55",2020-04-24,1261,667,65,38,37,41,0,36,5,7,10,48,38,8,154,5,517,0.0406199979782104,94,0.106379995346069,5.07369206501887,5.25164619579848,40.8720538389009,649.931982109383,41
"56",2020-04-25,1362,739,78,53,40.1,101,0,95,6,4,9,48,39,13,158,6,557,0.0502699995040894,28,0.0357100009918213,4.95731106864081,5.09400064090713,100.849986421136,720.523327536571,101
"57",2020-04-26,1416,758,87,88,47.3,54,0,41,13,5,9,50,41,9,163,13,358,0.0502799987792969,81,0.0123500001430511,4.32815252268233,4.96793308645194,53.7162217806356,741.453546901678,54
"58",2020-04-27,1477,782,95,87,57.4,61,0,54,7,8,11,56,45,8,171,7,269,0.0632000017166138,80,0.1,7.16355314090805,5.29250396155957,60.7470936829732,753.746751440725,61
"59",2020-04-28,1498,778,103,65,59.4,21,0,14,7,7,13,61,48,8,178,7,503,0.0616300010681152,11,0.272730007171631,6.61477054788909,5.05540023733637,20.766468228219,752.044611650624,21
"60",2020-04-29,1523,767,111,29,58.6,25,0,17,8,7,13,62,49,8,185,8,668,0.0314400005340576,74,0.148649997711182,4.31294072606172,5.13903078075198,24.825981016782,750.315929983972,25
"61",2020-04-30,1543,757,122,30,55.7,20,0,10,10,2,11,56,45,11,187,10,603,0.0414599990844727,6,0.333330001831055,4.43355656139956,5.26913951894292,19.7763929955632,740.072949764137,20
"62",2020-05-01,1566,741,135,42,56.3,23,0,16,7,6,11,57,46,13,193,7,516,0.031010000705719,55,0.0909099960327148,3.67797025323123,5.06975068868754,22.8701507628153,727.254530749452,23
"63",2020-05-02,1587,742,139,22,51.9,21,0,15,6,4,12,57,45,4,197,6,508,0.0511800003051758,28,0.0357100009918213,5.03718660126871,5.08116147906296,20.8475693013814,723.149403604167,21
"64",2020-05-03,1606,723,148,23,42.6,19,0,13,6,3,12,52,40,9,200,6,826,0.0205800008773804,231,0.0043299999833107,1.70286761786764,4.70612077837514,18.9484693895237,716.790561437603,19
"65",2020-05-04,1624,720,152,14,32.1,18,0,11,7,6,10,52,42,4,206,7,637,0.0109899997711182,24,0.125,1.51295459216373,3.89889241426881,17.9465857562293,714.50596349787,18
"66",2020-05-05,1649,720,156,29,27,25,0,24,1,3,9,50,41,4,209,1,923,0.0292499995231628,29,0.172409992218018,3.36109656871868,3.4340818458159,24.9830482655415,707.794751189913,25
"67",2020-05-06,1665,694,161,23,26.1,16,0,11,5,4,10,52,42,5,213,5,598,0.0167200005054474,149,0.0134200000762939,1.60617674881196,3.04740127763736,15.95949613291,688.378063247909,16
"68",2020-05-07,1688,672,167,32,26.4,23,0,16,7,6,10,54,44,6,219,7,813,0.0356699991226196,234,0.0128199994564056,3.05631224063884,2.85065208895726,22.8920981449764,661.641421917739,23
"69",2020-05-08,1701,639,173,16,22.7,13,0,8,5,4,8,54,46,6,223,5,715,0.00978999972343445,127,0.0472399997711182,1.54386339349022,2.54577968042283,12.9610675240186,634.024429569574,13
"70",2020-05-09,1718,623,179,12,21.3,17,0,12,5,5,6,51,45,6,228,5,1100,0.0154499995708466,164,0.0304900002479553,1.74013920637626,2.0747729097239,16.956117925885,617.532293565271,17
"71",2020-05-10,1730,554,185,25,21.6,12,0,8,4,3,5,52,47,6,231,4,907,0.0176400005817413,316,0.0126600003242493,1.6353262984548,2.06512414980778,11.9670088417901,549.430724587929,12
"72",2020-05-11,1750,535,188,14,21.6,20,0,14,6,1,5,51,46,3,232,6,517,0.00967000007629394,197,0.0152300000190735,1.12040616851561,2.00904580357234,19.9660953011031,531.976831015028,20
"73",2020-05-12,1773,518,193,13,19.3,23,0,17,6,4,6,51,45,5,236,6,835,0.0131700003147125,322,0.00310999989509583,1.03702422031165,1.67703546808562,22.9686185287742,515.290732984176,23
"74",2020-05-13,1794,500,195,21,19,21,0,15,6,2,7,47,40,2,238,6,1249,0.0144099998474121,224,0.0133899998664856,1.42548878340193,1.65122290159847,20.9568631721779,496.405264348155,21
"75",2020-05-14,1808,472,198,25,18,14,0,10,4,2,6,45,39,3,240,4,1046,0.0267700004577637,127,0.0236199998855591,2.6428951802461,1.59216332154237,13.9466820945116,465.708487152372,14
"76",2020-05-15,1828,458,201,17,18.1,20,0,12,8,1,5,44,39,3,241,8,1163,0.012039999961853,137,0.0146000003814697,1.23097846214588,1.54746547420746,19.9503323523434,455.156527171659,20
"77",2020-05-16,1844,438,207,19,19.1,16,0,6,10,1,4,42,38,6,242,10,967,0.0134399998188019,25,0.04,1.4109354662078,1.50043636846911,15.9288392854172,434.883160701275,16
"78",2020-05-17,1856,398,212,15,17.7,12,0,9,3,1,2,42,40,5,243,3,353,0.0254999995231628,10,0.1,2.7552341134095,1.66042319917693,11.9583118222522,392.469368418795,12
"79",2020-05-18,1871,390,213,26,19.4,15,0,8,7,2,1,43,42,1,245,7,376,0.0398900008201599,17,0.0588199996948242,4.07088557333133,2.08192025700774,14.8562790479617,381.992689815006,15
"80",2020-05-19,1883,353,219,23,20.9,12,0,8,4,0,1,40,39,6,245,4,359,0.0390000009536743,31,0.225809993743896,5.38490003805894,2.70304537382879,11.8913647452084,343.41293876464,12
"81",2020-05-20,1898,339,223,17,20.3,15,0,9,6,3,1,41,40,4,248,6,675,0.0296300005912781,36,0.0555600023269653,3.0942912071566,2.94144572007945,14.906363411211,333.709532733424,15
"82",2020-05-21,1906,325,229,11,18.3,8,0,1,7,0,1,38,37,6,248,7,478,0.0209200000762939,36,0,1.94547860631683,2.8418147809467,7.93131567261389,321.81108479993,8
"83",2020-05-22,1913,309,233,7,16.9,7,0,3,4,1,1,36,35,4,249,4,514,0.00583999991416931,14,0,0.568515143159664,2.74717716394867,6.98853074579035,308.114000112305,7
"84",2020-05-23,1922,305,236,6,15,9,1,3,5,1,0,35,35,3,250,6,582,0.00859000027179718,43,0,0.799900825309753,2.65988650096323,8.97579413841908,303.769535369637,9
"85",2020-05-24,1932,302,237,8,14,10,0,3,7,1,1,36,35,1,251,7,332,0.0150600004196167,25,0.04,1.68064989896716,2.50637447032861,9.94066534193319,299.440133323403,10
"86",2020-05-25,1947,298,240,6,11.1,15,1,7,7,0,1,35,34,3,251,8,401,0.0174600005149841,8,0,1.71184846124906,2.16936916860257,14.9309301593574,295.427148436064,15
"87",2020-05-26,1953,288,243,16,10.1,6,0,2,4,1,1,35,34,3,252,4,1123,0.00800999999046326,41,0.0731699991226196,1.03051545990701,1.54731422886658,5.97921032725539,286.503143562388,6
"88",2020-05-27,1958,260,243,8,8.9,5,0,1,4,1,1,33,32,0,253,4,1150,0.00957000017166138,13,0.0769199991226196,1.03228376491871,1.25274173711831,4.97917465337767,258.646352469548,5
"89",2020-05-28,1962,235,244,4,7.9,4,0,2,2,1,1,31,30,1,254,2,1403,0.00284999996423721,88,0,0.268179071081476,1.01312751779898,3.99729487070226,234.682147307515,4
"90",2020-05-29,1969,225,247,7,7.9,7,0,3,4,2,1,32,31,3,256,4,1380,0.0065200001001358,37,0,0.634975309681539,1.0226218273021,6.98718997491762,224.279436089116,7
"91",2020-05-30,1972,207,248,15,9.1,3,1,1,1,0,1,31,30,1,256,2,1020,0.0127499997615814,119,0,1.1417910234252,1.07146328417574,2.98848272411076,205.807961945464,3
"92",2020-05-31,1976,192,249,10,9.4,4,0,1,3,3,1,34,33,1,259,3,1309,0.00535000026226044,11,0.0909099960327148,0.606300022701422,0.917984730423489,3.99082635374183,191.412886639477,4
"93",2020-06-01,1987,182,250,5,9.3,11,0,5,6,0,1,31,30,1,259,6,763,0.00130999997258186,20,0,0.127653892602805,0.691671220616882,10.9961370555488,181.882824018315,11
"94",2020-06-02,1990,163,251,8,8.1,3,0,1,2,0,1,26,25,1,259,2,858,0.0104900002479553,9,0,1.03811075118174,0.692756262227556,2.98952854972613,162.14657680268,3
"95",2020-06-03,2000,154,251,8,8.1,10,0,7,3,0,0,22,22,0,259,3,1110,0.00449999988079071,141,0,0.399280564962245,0.602327233662347,9.99395866976154,153.689878381092,10
"96",2020-06-04,2007,144,254,8,8.7,7,0,2,5,0,0,20,20,3,259,5,1430,0.00559000015258789,21,0,0.550909732474203,0.642717328147022,6.98610739783201,143.599893057562,7
"97",2020-06-05,2011,135,256,15,9.9,4,0,1,3,1,0,21,21,2,260,3,1366,0.00952000021934509,29,0,0.932209340474939,0.685179332546079,3.98589517003484,134.365282651568,4
"98",2020-06-06,2014,126,257,2,8,3,0,0,3,0,0,21,21,1,260,3,1404,0.000710000023245811,68,0,0.0677201109128478,0.5317406307586,2.99897535820746,125.956965044713,3
"99",2020-06-07,2015,117,258,4,7.1,1,0,0,1,0,0,20,20,1,260,1,870,0.00230000004172325,22,0,0.22432735832951,0.477173107276898,0.998868602037335,116.867626438368,1
"100",2020-06-08,2018,109,258,0,6.4,3,0,0,3,0,0,19,19,0,260,3,701,0.0014300000667572,12,0,0.140593274445554,0.479021590397291,2.99787274795027,108.922709842193,3
"101",2020-06-09,2028,106,259,3,5.7,10,0,3,7,0,0,18,18,1,260,7,1338,0.00224000006914139,10,0,0.222338285794598,0.362482666770557,9.99215043765457,105.881135198769,10
"102",2020-06-10,2038,104,259,7,5.6,10,0,4,6,0,0,17,17,0,260,6,1281,0.00233999997377396,12,0,0.231828303666236,0.338560915156841,9.99298462552916,103.878400175839,10
"103",2020-06-11,2045,103,260,5,5.1,7,0,2,5,0,0,16,16,1,260,5,1529,0.00326999992132187,6,0,0.325721816267175,0.306391212841551,6.99178608881983,102.830793429688,7
"104",2020-06-12,2049,106,260,10,4.4,4,0,2,2,0,0,16,16,0,260,2,1596,0.00814999997615814,13,0,0.808415162333648,0.288706330249938,3.99184549513298,105.567811242048,4
"105",2020-06-13,2052,104,260,6,5,3,0,3,0,0,0,16,16,0,260,0,1479,0.00270000010728836,23,0.0434800004959106,0.332446083228058,0.326524326294968,3,103.825623598912,3
"106",2020-06-14,2055,101,260,1,4.6,3,0,1,2,0,0,16,16,0,260,2,768,0,13,0,0,0.294477560819324,3,101,3
"107",2020-06-15,2060,99,260,2,4.9,5,0,2,3,0,0,14,14,0,260,3,720,0.00555999994277954,17,0,0.543175028331244,0.351989239945851,4.99178146894341,98.7287884751326,5
"108",2020-06-16,2064,98,260,3,4.9,4,0,1,3,1,0,14,14,0,261,3,1250,0.000799999982118607,14,0,0.0791139222822989,0.331528616586951,3.99880296369794,97.9608968141327,4
"109",2020-06-17,2067,88,260,8,5,3,0,0,3,1,1,6,5,0,262,3,1098,0.0091100001335144,26,0,0.889927059305944,0.425542724535481,2.98653492374737,87.6050244299229,3
"110",2020-06-18,2069,74,260,2,4.6,2,0,0,2,0,1,6,5,0,262,2,1304,0.00230000004172325,122,0,0.210322584460527,0.409057119991674,1.99787847059464,73.9215034120018,2
"111",2020-06-19,2072,72,260,5,3.9,3,0,0,3,0,1,5,4,0,262,3,1875,0.0010700000077486,19,0,0.105926611115556,0.308701612674804,2.99839727325859,71.9615345582062,3
"112",2020-06-20,2078,72,261,1,3.1,6,0,0,6,1,1,5,4,1,263,6,1792,0.000560000017285347,158,0,0.0514625656910432,0.268561110169516,5.99844268726534,71.9813122471841,6
"113",2020-06-21,2084,76,261,1,3.1,6,0,0,6,0,1,4,3,0,263,6,1102,0.00363000005483627,86,0,0.336722227308887,0.316664285499357,5.98981042228291,75.8709320155835,6
"114",2020-06-22,2086,75,262,6,3.7,2,0,1,1,0,1,1,0,1,263,1,509,0.0039300000667572,10,0,0.385427752211834,0.294128960339441,1.99805609009595,74.854206757196,2
"115",2020-06-23,2095,80,262,4,3.9,9,0,0,9,0,1,1,0,0,263,9,1255,0.00158999994397163,20,0,0.156505876837992,0.305184953847398,8.99289594508818,79.9368528452283,9
"116",2020-06-24,2097,74,263,3,3.1,2,0,0,2,1,1,2,1,1,264,2,1733,0.00289000004529953,24,0,0.285052366448724,0.218774283439223,1.99712466933098,73.8936127652461,2
"117",2020-06-25,2103,72,263,6,3.7,6,0,0,6,0,1,2,1,0,264,6,1796,0.00277999997138977,21,0.0476200008392334,0.32982388366758,0.235845897611659,5.99001917360062,71.8802300832074,6
"118",2020-06-26,2107,66,263,6,3.9,4,0,0,4,0,1,2,1,0,264,4,2028,0.00196999996900558,23,0,0.194790830674955,0.248540786120145,3.99607027960187,65.9351596134309,4
"119",2020-06-27,2110,68,263,3,4.1,3,0,0,3,0,1,1,0,0,264,3,1574,0.000640000030398369,80,0,0.0609044768952257,0.249889630577885,2.99907848242511,67.9791122683025,3
"120",2020-06-28,2112,67,263,2,4.3,2,0,0,2,0,1,1,0,0,264,2,880,0.00114000000059605,12,0,0.112466367771807,0.217853079215445,1.99886554880945,66.9619958851165,2
"121",2020-06-29,2116,68,263,1,3.6,4,0,0,4,2,1,3,2,0,266,4,854,0.00351000010967255,8,0,0.347742470262222,0.212469467508358,3.99298462523133,67.8807386289326,4
"122",2020-06-30,2119,67,263,10,4.4,3,0,0,3,0,1,3,2,0,266,3,1605,0.00435999989509583,11,0,0.433032167798812,0.251973223359904,2.99344798981188,66.8536717724654,3
"123",2020-07-01,2121,66,263,4,4.6,2,0,0,2,0,2,3,1,0,266,2,1601,0.00312000006437302,15,0,0.309103966773589,0.255409166263456,1.99688206021001,65.8971079869304,2
"124",2020-07-02,2127,65,263,4,4.3,6,0,1,5,0,1,3,2,0,266,5,1012,0.00197999998927116,12,0,0.195679686439689,0.236245709516614,5.99506543472403,64.9358506514123,6
"125",2020-07-03,2135,73,263,4,4,8,0,0,8,0,1,3,2,0,266,8,1334,0.00300000011920929,14,0,0.296884284794154,0.2508304886765,7.98802128184579,72.8906941968429,8
"126",2020-07-04,2138,73,263,4,4.1,3,0,0,3,0,1,3,2,0,266,3,1257,0.00317999988794327,40,0,0.308192741645697,0.286157383640853,2.99533687764253,72.8865306893016,3
"127",2020-07-05,2140,70,263,5,4.6,2,0,0,2,0,1,2,1,0,266,2,734,0.00272000014781952,47,0,0.255631255889824,0.306609510514855,1.99742144084198,69.9097504294694,2
"128",2020-07-06,2146,70,263,0,4.4,6,0,1,5,0,1,2,1,0,266,5,602,0,10,0,0,0.256932014763109,6,70,6
"129",2020-07-07,2153,71,263,6,3.9,7,0,1,6,0,1,1,0,0,266,6,1272,0.0039300000667572,21,0,0.386617175940848,0.250301301640543,6.98830054733097,70.8615564767498,7
"130",2020-07-08,2166,77,263,5,4,13,0,1,12,0,1,1,0,0,266,12,1684,0.00296999990940094,39,0,0.29027741424441,0.247611794136374,12.982431784824,76.8872706192871,13
"131",2020-07-09,2174,81,263,5,4.1,8,0,0,8,1,0,2,2,0,267,8,1504,0.00266000002622604,41,0,0.258941102876632,0.256649139341652,7.98955221731575,80.894216200322,8
"132",2020-07-10,2190,94,263,12,5.3,16,0,0,16,0,0,2,2,0,267,16,1900,0.00684000015258789,14,0.0714300012588501,0.73124453017455,0.318700602967423,15.9409913385288,93.6533241138568,16
"133",2020-07-11,2197,99,263,7,5.7,7,0,0,7,1,1,2,1,0,268,7,1571,0.00381999999284744,25,0,0.376016290022765,0.328389681307004,6.98672489849923,98.8122521359177,7
"134",2020-07-12,2220,119,263,9,6.3,23,0,2,21,1,1,3,2,0,269,21,1068,0.00842999994754791,13,0,0.832862159480219,0.410851238962775,22.9117884251564,118.50013440922,23
"135",2020-07-13,2243,137,263,6,7.1,23,0,2,21,0,0,3,3,0,269,21,808,0.00619000017642975,65,0,0.572911814725686,0.492695783923587,22.9393207473191,136.604140113463,23
"136",2020-07-14,2262,147,263,4,6.9,19,0,2,17,1,0,4,4,0,270,17,1406,0.00356000006198883,66,0,0.340038049399205,0.486041622989067,18.970845232137,146.747897007302,19
"137",2020-07-15,2283,167,263,15,8.3,21,0,0,21,1,0,5,5,0,271,21,1404,0.00782999992370606,46,0,0.758159992612641,0.552881991327386,20.9197004136032,166.361427098654,21
"138",2020-07-16,2305,185,263,7,8.6,22,0,1,21,0,0,5,5,0,271,21,1695,0.00708000004291534,25,0.04,0.75584884143846,0.623868811121932,21.9199451963472,184.294755301154,22
"139",2020-07-17,2335,212,263,17,9.3,30,0,0,29,0,1,5,4,0,271,29,1787,0.00726999998092651,21,0,0.718555860946664,0.622056144089377,28.8949026696855,211.231702274942,30
"140",2020-07-18,2361,231,263,16,10.6,26,0,0,24,2,1,6,5,0,273,24,1551,0.00708999991416931,81,0,0.673810653607635,0.664598196030073,23.9184390519579,230.214975875095,26
"141",2020-07-19,2379,249,263,28,13.3,18,0,0,18,0,1,6,5,0,273,18,2025,0.0212299990653992,22,0,2.10018310246377,0.845644045027723,17.8093385834933,246.362517071657,18
"142",2020-07-20,2409,274,263,47,19.1,30,0,0,27,2,3,8,5,0,275,27,1548,0.0148599994182587,35,0.0285700011253357,1.51631264301018,0.980415591925508,26.7935163490905,271.9045733204,30
"143",2020-07-21,2433,293,263,23,21.9,24,0,0,23,0,3,8,5,0,275,23,1428,0.0161099994182587,15,0,1.59425358068423,1.15958923925194,22.8150653084334,290.644092842217,24
"144",2020-07-22,2460,313,263,13,21.6,27,0,1,23,2,3,9,6,0,277,23,1771,0.00902999997138977,16,0,0.894914938406899,1.17912566007969,23.8961891507613,311.587269747317,27
"145",2020-07-23,2479,321,263,29,24.7,19,0,1,17,1,3,10,7,0,278,17,1667,0.0101999998092651,32,0,1.0007886805206,1.21411706566285,17.9141926566393,319.379755457718,19
"146",2020-07-24,2502,336,263,34,27.1,23,0,1,18,0,3,7,4,0,278,18,2036,0.0122800004482269,83,0,1.17989999587494,1.28002337065261,18.8928848611886,334.000517408854,23
"147",2020-07-25,2514,335,263,26,28.6,12,0,1,10,0,3,7,4,0,278,10,2126,0.00800000011920929,320,0,0.695339339878943,1.28309889726279,10.9649304695442,333.825170729732,12
"148",2020-07-26,2521,337,263,21,27.6,7,0,0,6,2,4,9,5,0,280,6,1816,0.0121099996566772,73,0,1.16420113163186,1.14938718714395,5.96477001829106,335.021249360681,7
"149",2020-07-27,2536,339,264,22,24,15,0,1,13,1,4,9,5,1,281,13,1601,0.00874000012874603,24,0,0.861091704992148,1.05578419599852,13.9435419455596,337.527747657284,15
"150",2020-07-28,2556,329,264,14,22.7,20,0,2,17,1,4,10,6,0,282,17,1488,0.00739000022411346,24,0,0.727269863325452,0.931929379232978,18.937644084018,327.793229625995,20
"151",2020-07-29,2572,323,264,20,23.7,16,2,2,12,2,4,11,7,0,284,14,2254,0.00620999991893768,52,0,0.606996522865808,0.890798177012822,15.9571404714877,322.011169449324,16
"152",2020-07-30,2592,333,264,19,22.3,20,1,0,18,1,4,12,8,0,285,19,1891,0.00898999989032745,134,0,0.839510607042431,0.867758452230227,18.9195524284117,331.590050455847,20
"153",2020-07-31,2602,320,264,18,20,10,0,1,9,1,3,13,10,0,286,9,2129,0.00797999978065491,207,0,0.727286795077667,0.803099423544901,9.9669872759205,318.826214254951,10
"154",2020-08-01,2619,307,264,15,18.4,17,0,0,17,1,2,13,11,0,287,17,1629,0.00551999986171722,83,0.0120500004291534,0.583658283315251,0.787144986892945,16.9499573009801,306.096287729465,17
"155",2020-08-02,2627,292,264,2,15.7,8,0,0,8,0,2,13,11,0,287,8,1340,0.00149000003933907,11,0,0.147786828476266,0.641942943585003,7.99403708159747,291.782353478308,8
"156",2020-08-03,2636,278,264,10,14,9,0,1,7,0,1,12,11,0,287,7,1046,0.0114699995517731,47,0,1.09767790769942,0.675740972543185,7.9612469299163,276.46094950239,9
"157",2020-08-04,2648,266,264,20,14.9,12,0,1,11,1,1,11,10,0,288,11,1699,0.0058899998664856,12,0,0.584869069150148,0.655398001946712,11.96755225729,265.215354585377,12
"158",2020-08-05,2657,246,264,12,13.7,9,1,0,8,1,1,12,11,0,289,9,1599,0.005,70,0,0.479029358897543,0.637116978522675,8.97825608252715,245.405666255742,9
"159",2020-08-06,2667,222,264,12,12.7,10,0,0,10,1,2,10,8,0,290,10,1639,0.00305000007152557,10,0,0.303150401287472,0.560494091986252,9.98471056990321,221.660574651851,10
"160",2020-08-07,2679,223,264,6,11,12,0,3,9,1,2,10,8,0,291,9,1689,0,39,0,0,0.456595978403728,12,223,12
"161",2020-08-08,2685,206,264,14,10.9,6,1,1,4,0,1,10,9,0,291,5,1518,0.00725000023841858,95,0,0.682300084433937,0.470687664277826,5.98279405304812,205.291114985582,6
"162",2020-08-09,2687,197,264,16,12.9,2,0,1,1,2,2,12,10,0,293,1,1589,0.00441000014543533,102,0,0.414399185753799,0.508775143888902,1.99790997229235,196.588264541594,2
"163",2020-08-10,2699,198,264,8,12.6,12,2,0,10,0,1,12,11,0,293,12,1384,0.00578000009059906,27,0,0.566939767922686,0.432955409635084,11.9656875824781,197.433845110889,12
"164",2020-08-11,2712,202,264,8,10.9,13,2,1,10,0,1,12,11,0,293,12,1460,0.00342000007629395,41,0,0.332658235269098,0.396925290509219,12.9798668061292,201.661091236509,13
"165",2020-08-12,2719,185,264,12,10.9,7,3,0,4,0,2,10,8,0,293,7,1486,0.00268999993801117,7,0,0.267738774808078,0.366740921353581,6.99054759193796,184.75018635836,7
"166",2020-08-13,2741,188,264,11,10.7,22,0,0,22,0,2,9,7,0,293,22,1689,0.00532999992370605,56,0,0.515895121555274,0.397133024248982,21.9427576767091,187.510838328242,22
"167",2020-08-14,2752,183,264,6,10.7,11,4,1,6,1,2,10,8,0,294,10,1882,0.00477999985218048,36,0,0.469028139822923,0.464137044223685,10.9763445044876,182.567104432122,11
"168",2020-08-15,2756,175,264,2,9,4,0,0,4,1,2,11,9,0,295,4,2044,0.00734000027179718,21,0,0.726535620123653,0.470456406465073,3.98534283242967,174.358748918798,4
"169",2020-08-16,2760,157,264,26,10.4,4,0,1,3,0,2,11,9,0,295,3,1196,0.00501999974250793,22,0,0.492932651234769,0.481675472962354,3.99254166319938,156.609680374101,4
"170",2020-08-17,2783,171,265,8,10.4,23,1,4,18,1,1,9,8,1,296,19,1358,0.00662999987602234,32,0,0.647736678535132,0.493217888764132,22.9379295003783,170.441365503405,23
"171",2020-08-18,2809,190,265,15,11.4,26,1,1,24,0,1,7,6,0,296,25,1888,0.00583000004291534,77,0.0519500017166138,0.76372469278389,0.554798811266246,25.9037036133391,189.268147461377,26
"172",2020-08-19,2833,199,265,23,13,24,4,3,15,2,1,7,6,0,298,19,1519,0.0118499994277954,25,0.04,1.23057960691847,0.692347501567731,21.882077557815,197.76491757922,24
"173",2020-08-20,2850,207,266,24,14.9,17,1,0,16,3,0,6,6,1,301,17,1607,0.00995999991893768,103,0,0.936007009925898,0.752363485620677,16.919747019074,206.022801938137,17
"174",2020-08-21,2871,214,266,16,16.3,21,3,2,16,0,0,6,6,0,301,19,1804,0.00721000015735626,116,0.00861999988555908,0.729518764093518,0.789576431945048,20.9300925890547,213.212621792511,21
"175",2020-08-22,2890,224,266,16,18.3,19,1,0,18,1,0,7,7,0,302,19,1864,0.00589999973773956,73,0,0.567764559171221,0.766894851808986,18.9455929685271,223.358569734214,19
"176",2020-08-23,2907,234,266,13,16.4,17,0,1,15,0,0,7,7,0,302,15,694,0.0172899997234344,5,0,1.71663230444399,0.941709087981732,15.8701321381603,231.974061355301,17
"177",2020-08-24,2926,250,266,19,18,19,2,0,17,1,1,8,7,0,303,19,1142,0.00962999999523163,58,0,0.91645499954621,0.980097419554743,18.9121790974826,248.844461808981,19
"178",2020-08-25,2940,252,266,23,19.1,14,0,1,13,4,2,11,9,0,307,13,1647,0.0145700001716614,73,0,1.3951622257399,1.0703027814056,13.9085252541194,250.226797233699,14
"179",2020-08-26,2958,260,266,15,18,18,1,4,13,0,2,11,9,0,307,14,1832,0.0049099999666214,41,0,0.480251998870817,0.96311312311308,17.966089798766,259.370239119941,18
"180",2020-08-27,2971,263,266,16,16.9,13,1,3,9,1,2,9,7,0,308,10,1469,0.00612999975681305,9,0,0.609267228874044,0.916436011534243,12.9692715277084,262.191841178732,13
"181",2020-08-28,2999,273,266,20,17.4,28,0,3,21,1,1,9,8,0,309,21,2137,0.00607999980449677,35,0,0.598202559033591,0.897676553668539,23.9366421091327,272.176347418726,28
"182",2020-08-29,3020,287,266,12,16.9,21,0,2,18,0,1,9,8,0,309,18,1790,0.00726000010967255,11,0.0909099960327148,0.777091068999096,0.927580340786807,19.9294531587287,285.875169808619,21
"183",2020-08-30,3040,301,267,16,17.3,20,0,6,12,2,1,10,9,1,311,12,1402,0.00428000003099442,33,0,0.418157494317364,0.742083939340146,17.9746922065681,300.365196181417,20
"184",2020-08-31,3060,309,267,13,16.4,20,1,3,16,1,1,11,10,0,312,17,1353,0.00517000019550324,54,0,0.497157801315983,0.682184339592971,19.9573738282693,308.225206643248,20
"185",2020-09-01,3085,313,267,18,15.7,25,1,2,22,0,1,11,10,0,312,23,1361,0.0154299998283386,22,0.0909099960327148,1.6630693911127,0.720456791789084,24.8070826193363,310.374646080533,25
"186",2020-09-02,3121,323,267,15,15.7,36,1,9,26,0,1,9,8,0,312,27,1528,0.00261999994516373,51,0,0.253537676770752,0.688069031489075,35.9654745441951,322.586973250926,36
"187",2020-09-03,3143,324,267,24,16.9,22,1,4,17,1,1,8,7,0,313,18,1493,0.00938000023365021,133,0.00751999974250793,0.922785997207461,0.732857426965278,21.916226501797,322.492077032347,22
"188",2020-09-04,3165,328,267,24,17.4,22,0,3,19,3,1,11,10,0,316,19,2705,0.00813000023365021,258,0.00774999976158142,0.809691210614641,0.763070091476856,21.922409924206,326.660550270503,22
"189",2020-09-05,3190,335,267,17,18.1,25,1,11,13,2,1,13,12,0,318,14,2256,0.00398999989032745,164,0,0.371960320354493,0.705194270241913,24.9737361857027,334.371544443599,25
"190",2020-09-06,3211,337,267,26,19.6,21,1,3,16,1,1,14,13,0,319,17,1310,0.00611000001430511,192,0.03125,0.932363516560566,0.778652273419513,19.9200594111827,335.415295386386,21
"191",2020-09-07,3252,362,267,29,21.9,41,2,6,33,0,1,12,11,0,319,35,1290,0.0147300004959106,44,0,1.4244153403092,0.91111763613283,40.74855799172,359.399371228647,41
"192",2020-09-08,3304,399,267,24,22.7,52,0,14,36,3,1,14,13,0,322,36,1097,0.0127600002288818,4,0,1.27136423715562,0.855159756996105,49.7691628829241,396.441555285743,52
"193",2020-09-09,3349,430,267,15,22.7,45,2,10,31,0,1,13,12,0,322,33,1587,0.0144900000095367,29,0,1.42299690687715,1.02222536129702,42.7631621847679,426.913931498491,45
"194",2020-09-10,3426,492,267,33,24,77,1,21,52,2,2,14,12,0,324,53,1959,0.0127600002288818,61,0,1.23746734892968,1.06717984011448,73.6692173146554,488.929338090763,77
"195",2020-09-11,3456,506,267,60,29.1,30,0,1,25,0,1,12,11,0,324,25,2314,0.0155599999427795,93,0.0752699995040894,1.78670335776785,1.20675300399351,25.7747184567769,501.440301565165,30
"196",2020-09-12,3505,531,269,47,33.4,49,0,4,42,1,0,12,12,2,325,42,1900,0.0168400001525879,26,0,1.66126688940379,1.39093965671484,45.6480979070023,526.550952109958,49
"197",2020-09-13,3540,544,270,31,34.1,35,1,5,29,1,1,11,10,1,326,30,1199,0.0166799998283386,44,0,1.6089557356539,1.48759568801389,34.7565563217666,539.585554634702,35
"198",2020-09-14,3608,594,272,59,38.4,68,0,19,49,1,1,11,10,2,327,49,2394,0.0141999995708466,218,0.0412799978256226,1.6460121936674,1.51925238135077,67.5932174837749,589.068799701271,68
"199",2020-09-15,3681,643,273,41,40.9,73,0,15,55,1,1,11,10,1,328,55,2961,0.0121599996089935,28,0,1.20460886056306,1.5097158989804,69.6658496710169,639.093478881162,73
"200",2020-09-16,3758,683,274,41,44.6,77,0,7,67,1,0,11,11,1,329,67,1887,0.0190799999237061,162,0.00616999983787537,1.80592971350752,1.56442058564189,73.3897485829451,676.779078838082,77
"201",2020-09-17,3808,708,278,57,48,50,2,4,38,2,2,11,9,4,331,40,2512,0.0191100001335144,208,0.00481000006198883,1.80164707162801,1.6450176888845,43.6365347781991,701.566665574124,50
"202",2020-09-18,3896,776,278,47,46.1,88,1,6,78,0,2,11,9,0,331,79,2409,0.0128699994087219,281,0.0213499999046326,1.37558284568078,1.58628618715778,84.4519161656746,770.616290437512,88
"203",2020-09-19,3966,826,280,47,46.1,70,2,4,60,0,2,10,8,2,331,62,2101,0.0214199995994568,161,0,1.98954107685494,1.6331824996508,65.3778748622515,817.711687680964,70
"204",2020-09-20,4009,858,280,76,52.6,43,1,4,34,2,2,11,9,0,333,35,2847,0.0186199998855591,112,0,1.79152212484578,1.6592634123925,38.6837552164726,850.247485020957,43
"205",2020-09-21,4118,938,280,55,52,109,2,22,82,1,3,12,9,0,334,84,2949,0.0189900004863739,73,0,1.85312744653596,1.68885130565944,105.214913110967,929.233196405802,109
"206",2020-09-22,4227,1017,280,85,58.3,109,0,27,81,3,3,15,12,0,337,81,2507,0.0135599994659424,64,0.03125,1.4000357316654,1.71676943010263,107.428051021119,1009.81886282072,109
"207",2020-09-23,4333,1076,281,67,62,106,0,26,75,2,3,16,13,1,339,75,1896,0.0168799996376038,7,0.571430015563965,1.89198578149472,1.7290631541008,100.284330874359,1065.7325336108,106
"208",2020-09-24,4434,1130,282,38,59.3,101,2,18,75,2,3,18,15,1,341,77,2730,0.0128199994564056,55,0,1.25668217292594,1.65121102571479,94.5119668422166,1122.8379549572,101
"209",2020-09-25,4553,1193,284,57,60.7,119,5,16,86,3,3,20,17,2,344,91,3291,0.0133700001239777,59,0.0339000010490417,1.37315732745982,1.65086452311179,106.369776140106,1184.73783445216,119
"210",2020-09-26,4638,1240,286,76,64.9,85,3,14,66,3,4,21,17,2,347,69,3437,0.0299699997901916,12,0,2.98657260883992,1.79329759910965,81.9606655598288,1221.32210571287,85
"211",2020-09-27,4720,1270,287,109,69.6,82,2,12,64,2,4,22,18,1,349,66,2684,0.0331599998474121,13,0,3.30001629923819,2.00879676687999,76.9015174287948,1248.86253234196,82
"212",2020-09-28,4835,1340,288,86,74,115,3,11,97,6,4,27,23,1,355,100,3135,0.0258400011062622,192,0.0104200005531311,2.49501182970644,2.10049453590435,109.741637523851,1323.1379428196,115
"213",2020-09-29,4942,1371,291,58,70.1,107,5,18,74,4,3,27,24,3,359,79,2165,0.0263299989700317,79,0.0253200006484985,2.62944419881239,2.27612431692535,95.9523307424522,1352.81829680889,107
"214",2020-09-30,5025,1400,291,107,75.9,83,1,10,67,5,5,30,25,0,364,68,3170,0.0305999994277954,281,0.0142299997806549,2.92670611777675,2.42394150782278,76.9962601230326,1379.33476723891,83
"215",2020-10-01,5126,1436,293,105,85.4,101,2,11,78,3,5,29,24,2,367,80,3844,0.0226300001144409,120,0.00833000004291534,2.21971040476944,2.56151696951471,90.1043889257686,1419.92378121755,101
"216",2020-10-02,5222,1486,294,115,93.7,96,0,13,79,1,5,29,24,1,368,79,3362,0.021710000038147,197,0,2.05082945007727,2.65832727274577,91.1828725750142,1470.62972970217,96
"217",2020-10-03,5295,1498,295,65,92.1,73,2,6,64,5,6,31,25,1,373,66,3113,0.0301999998092651,485,0.0103100001811981,2.75188853513406,2.62480097650208,71.08397373842,1477.20897969929,73
"218",2020-10-04,5352,1479,295,77,87.6,57,1,7,47,3,6,32,26,0,376,48,3118,0.0291899991035461,102,0,2.82653469580301,2.55716074743991,54.3157280959297,1457.91587195583,57
"219",2020-10-05,5430,1480,295,82,87,78,3,13,59,3,6,33,27,0,379,62,3821,0.0177999997138977,238,0.00839999973773956,1.72488294763206,2.447142335715,74.460632879673,1467.12478486961,78
"220",2020-10-06,5506,1453,296,139,98.6,76,5,15,53,2,7,34,27,1,381,58,2158,0.0194599997997284,55,0,1.89763576899295,2.34259827431222,72.4448964539297,1439.09369909586,76
"221",2020-10-07,5607,1467,296,174,108.1,101,12,22,63,3,10,36,26,0,384,75,2268,0.0313100004196167,76,0,3.02948297575472,2.35728068259479,95.8540572272746,1444.58535936549,101
"222",2020-10-08,5687,1426,296,85,105.3,80,5,14,55,2,9,36,27,0,386,60,2434,0.0271199989318848,182,0,2.52332100153698,2.40065362499015,73.2364158536307,1407.85215012129,80
"223",2020-10-09,5771,1428,296,97,102.7,84,5,19,58,2,9,37,28,0,388,63,2508,0.0207299995422363,247,0.00810000002384186,1.95976547578285,2.38764448580523,81.3773015247176,1413.88550122693,84
"224",2020-10-10,5836,1413,297,67,103,65,5,7,51,6,9,43,34,1,394,56,2628,0.0300600004196167,21,0,2.98216991705371,2.42054182607947,62.1577256753629,1391.74761391585,65
"225",2020-10-11,5900,1378,297,140,112,64,6,6,48,5,10,46,36,0,399,54,2660,0.0233100008964539,238,0.0168099999427795,2.2776184393012,2.34212521800778,59.3796912887411,1362.17064066454,64
"226",2020-10-12,5962,1350,297,63,109.3,62,2,14,43,3,10,46,36,0,402,45,1994,0.0150499999523163,237,0.0126600003242493,1.47961093598233,2.30708635920068,58.6641903310689,1339.92570993207,62
"227",2020-10-13,6047,1372,298,74,100,85,4,10,68,1,7,45,38,1,403,72,2117,0.0302300000190735,18,0,2.9975133508374,2.4642117280356,80.9115041620933,1351.25810708878,85
"228",2020-10-14,6114,1377,300,84,87.1,67,1,16,49,2,7,45,38,2,405,50,3004,0.0296300005912781,110,0.0363599991798401,2.98677333609447,2.45811035094128,65.2468084827987,1356.25710561628,67
"229",2020-10-15,6200,1404,300,107,90.3,86,3,25,52,5,8,49,41,0,410,55,2119,0.021710000038147,105,0.00952000021934509,2.11344829603708,2.39955710729843,79.4137437748222,1389.03447745182,86
"230",2020-10-16,6275,1425,301,78,87.6,75,2,10,59,4,8,47,39,1,414,61,3126,0.0214299988746643,280,0.0035699999332428,1.99617664308598,2.40475870262745,70.3858676782029,1410.6534662531,75
"231",2020-10-17,6322,1407,302,64,87.1,47,1,10,36,6,8,49,41,1,420,37,3037,0.0214000010490417,149,0,2.03991849296735,2.2701513563294,46.6193308438485,1392.52428371067,47
"232",2020-10-18,6379,1374,305,74,77.7,57,1,11,40,2,6,47,41,3,422,41,1144,0.0271000003814697,37,0.0540500020980835,2.79443272769098,2.34398196895651,51.4221559231261,1354.63517654574,57
"233",2020-10-19,6443,1352,307,69,78.6,64,1,6,57,3,6,46,40,2,425,58,1334,0.0374799990653992,27,0,3.67364575703472,2.65741551482114,62.9253713383479,1326.95003533528,64
"234",2020-10-20,6521,1356,309,46,74.6,78,3,14,57,4,5,45,40,2,429,60,1595,0.0250799989700317,48,0.0208299994468689,2.49558358677117,2.58571126281168,73.244809494457,1338.93269457473,78
"235",2020-10-21,6609,1378,312,69,72.4,88,1,46,40,4,4,44,40,3,433,41,2258,0.0305599999427795,446,0.00897000014781952,2.69989274913919,2.54472832181807,86.4417052814244,1359.23585067812,88
"236",2020-10-22,6675,1365,312,88,69.7,66,2,24,36,1,3,43,40,0,434,38,2238,0.0268099999427795,87,0.0114900004863739,2.62367354469915,2.61761764305551,61.4971637915212,1346.93759409017,66
"237",2020-10-23,6754,1367,313,92,71.7,79,1,13,64,2,3,36,33,1,436,65,2768,0.0245700001716614,65,0.0153799998760223,2.4359145946735,2.68043735042515,77.2014381395094,1350.20562979553,79
"238",2020-10-24,6819,1360,317,63,71.6,65,2,17,41,2,3,36,33,4,438,43,2358,0.0211999988555908,191,0,1.96114544140773,2.6691840573452,59.5746843057525,1346.54815478659,65
"239",2020-10-25,6889,1341,319,69,70.9,70,1,24,42,3,3,38,35,2,441,43,1751,0.0308400011062622,77,0,2.95409419787008,2.69199283879936,66.3593424546127,1321.02042399153,70
"240",2020-10-26,6962,1300,320,77,72,73,1,16,51,4,3,39,36,1,445,52,995,0.0392000007629395,121,0.0165299999713898,3.67420526484435,2.69207276848645,67.0363930825705,1275.90982706426,73
"241",2020-10-27,7040,1270,322,61,74.1,78,0,15,60,1,3,31,28,2,446,60,1354,0.0288000011444092,116,0,2.65273479928776,2.71452294170311,74.1972538428426,1253.0085396735,78
"242",2020-10-28,7152,1276,325,94,77.7,112,2,69,38,2,2,29,27,3,448,40,1900,0.0405299997329712,166,0.01807000041008,3.87253724882471,2.88204358451532,108.21875231157,1251.07819873908,112
"243",2020-10-29,7216,1261,326,65,74.4,64,0,18,42,9,2,37,35,1,457,42,2190,0.0292199993133545,96,0,2.79929127280168,2.90713183138712,59.4070329914523,1243.19687148146,64
"244",2020-10-30,7266,1230,328,122,78.7,50,1,9,36,4,2,40,38,2,461,37,2789,0.0358599996566772,105,0.0571400022506714,3.66320799166528,3.0824594595288,45.31640881741,1207.27521203822,50
"245",2020-10-31,7305,1160,329,83,81.6,39,0,5,32,2,2,39,37,1,463,32,2352,0.0276399993896484,322,0,2.43116224997955,3.1496047178962,36.6076288456987,1145.77654565658,39
"246",2020-11-01,7355,1120,332,50,78.9,50,1,6,40,1,2,37,35,3,464,41,1714,0.0256699991226196,104,0,2.42015283257261,3.07332737999656,46.4995510303134,1106.32919887685,50
"247",2020-11-02,7419,1072,332,56,75.9,64,3,8,47,6,2,42,40,0,470,50,1030,0.0174800002574921,14,0.0714300012588501,1.82034677038704,2.80849045221695,57.5409528639983,1062.15802940412,64
"248",2020-11-03,7490,1000,333,36,72.3,71,1,36,33,1,2,43,41,1,471,34,1456,0.0219799995422363,13,0,2.17854862719511,2.74074957048943,69.6264236921934,989.012461535099,71
"249",2020-11-04,7555,924,337,53,66.4,65,5,1,51,1,1,40,39,4,472,56,1466,0.0272900009155273,295,0.0033899998664856,2.32863096551825,2.52019153001707,56.3423090808492,913.148099834012,65
"250",2020-11-05,7602,881,337,45,63.6,47,0,6,34,5,2,43,41,0,477,34,2536,0.0240499997138977,41,0,2.36673648717286,2.45839798921296,39.5941533425547,870.483796905608,47
"251",2020-11-06,7676,875,341,79,57.4,74,1,12,58,4,3,46,43,4,481,59,2342,0.0234800004959106,116,0.0258599996566772,2.35923194148077,2.27211569632945,70.297969789849,864.588535018947,74
"252",2020-11-07,7711,841,346,75,56.3,35,3,4,25,3,4,46,42,5,484,28,2499,0.0276099991798401,142,0,2.61254782091709,2.2980279207491,31.6310602660731,829.918631563125,35
"253",2020-11-08,7748,779,346,47,55.9,37,1,5,29,1,4,47,43,0,485,30,1176,0.0204099988937378,92,0.0108700001239777,1.97178223268467,2.23397497790797,34.701658716419,771.253071336348,37
"254",2020-11-09,7818,747,350,31,52.3,70,3,24,41,7,4,46,42,4,492,44,711,0.0210999989509583,20,0.1,2.3258685710166,2.30619237799791,67.4838558648401,738.237280250808,70
"255",2020-11-10,7885,756,350,51,54.4,67,0,11,54,3,5,47,42,0,495,54,1374,0.0334800004959106,17,0,3.30708272332,2.46741153458718,64.0993169941324,743.390437917854,67
"256",2020-11-11,7941,755,353,78,58,56,0,6,48,2,5,46,41,3,497,48,2375,0.0261100006103516,241,0.0290499997138977,2.63808491516186,2.51161924167912,53.3613496446099,744.954562118343,56
"257",2020-11-12,7983,745,355,58,59.9,42,1,8,31,3,3,43,40,2,500,32,2318,0.0215700006484985,214,0.00467000007629395,2.01416435701211,2.4612517945133,39.6749291439845,737.431944133389,42
"258",2020-11-13,8021,721,357,81,60.1,38,1,7,26,0,3,36,33,2,500,27,2719,0.0217000007629395,200,0,2.02131901591067,2.41297851943186,33.7247471806148,713.649730267529,38
"259",2020-11-14,8042,698,357,50,56.6,21,3,2,14,3,3,37,34,0,503,17,1710,0.015789999961853,245,0.0163300001621246,1.58576726212221,2.26629558246116,18.8640367556112,692.417509142156,21
"260",2020-11-15,8072,654,360,29,54,30,1,1,25,0,2,35,33,3,503,26,984,0.0152400004863739,306,0.00653999984264374,1.31762794034426,2.17284496926967,26.8272176829555,649.653860178957,30
"261",2020-11-16,8116,615,363,11,51.1,44,0,3,39,3,2,33,31,3,506,39,735,0.0122399997711182,53,0,1.1416751055548,2.0036744742037,41.7754359208583,611.458797213535,44
"262",2020-11-17,8157,593,363,39,49.4,41,1,10,29,1,2,32,30,0,507,30,1828,0.020789999961853,38,0,2.03666237568421,1.82218585311287,39.6918420009519,586.90874355215,41
"263",2020-11-18,8198,585,363,66,47.7,41,3,6,30,1,2,32,30,0,508,33,2684,0.0204900002479553,20,0.05,2.07082694768906,1.74114900061676,38.6553399886928,578.890117981373,41
"264",2020-11-19,8218,569,364,53,47,20,2,1,17,0,2,30,28,1,508,19,2476,0.0121200001239777,187,0.0160399997234344,1.23952685900304,1.63048650090118,19.881220171742,565.442856722169,20
"265",2020-11-20,8243,526,364,28,39.4,25,1,2,20,1,2,30,28,0,509,21,2643,0.00757000029087067,222,0.0225200009346008,0.872842966012306,1.46641849377284,22.9075539070341,523.684445480949,25
"266",2020-11-21,8272,496,365,27,36.1,29,4,4,19,2,2,31,29,1,511,23,1495,0.0187300002574921,71,0,1.7880811229215,1.49532047388702,26.792581158374,491.526967589284,29
"267",2020-11-22,8299,482,368,26,35.7,27,3,4,19,3,4,31,27,3,514,22,1220,0.0147500002384186,36,0,1.4327229530948,1.51176261856567,25.8410289474728,478.517088758268,27
"268",2020-11-23,8339,465,370,20,37,40,2,10,25,1,3,27,24,2,515,27,922,0.0173500001430511,13,0,1.71087701945381,1.5930771776941,36.7670215737748,460.987593770566,40
"269",2020-11-24,8383,475,370,21,34.4,44,2,7,34,1,3,23,20,0,516,36,1403,0.00855000019073486,41,0.0975599956512451,1.10772923056108,1.46037244267651,42.798873513498,472.346247747543,44
"270",2020-11-25,8438,483,371,38,30.4,55,4,10,39,2,2,23,21,1,518,43,2618,0.0122200000286102,72,0.0138900005817413,1.22646989281736,1.33975000626627,52.7340141720632,480.012298723408,55
"271",2020-11-26,8483,498,372,60,31.4,45,3,4,37,3,2,23,21,1,521,40,3059,0.0143799996376038,224,0.00446000009775162,1.37031553193196,1.35843410239897,43.7235518284384,494.558220264058,45
"272",2020-11-27,8529,509,374,56,35.4,46,2,3,40,3,1,24,23,2,524,42,3154,0.0177600002288818,336,0.00298000007867813,1.63370546556817,1.46712874519267,44.6539361758534,504.806036035938,46
"273",2020-11-28,8574,512,375,60,40.1,45,2,3,40,2,1,25,24,1,526,42,2597,0.0119400000572205,191,0,1.11220158352229,1.3705745252785,44.7644050648495,509.12798555245,45
"274",2020-11-29,8619,526,377,23,39.7,45,0,4,38,5,1,28,27,2,531,38,898,0.0245000004768372,12,0,2.41769235474723,1.51128443980027,41.5366408067858,519.586133272877,45
"275",2020-11-30,8663,533,378,45,43.3,44,1,7,35,1,1,25,24,1,532,36,1135,0.0229099988937378,61,0,2.17415123280873,1.57746647027955,42.6052470346411,527.155463040658,44
"276",2020-12-01,8716,553,378,34,45.1,53,2,11,39,3,1,27,26,0,535,41,1906,0.0141700005531311,113,0.0176999998092651,1.43675686145195,1.62447041754967,51.7029016178951,548.992794992586,53
"277",2020-12-02,8758,567,379,50,46.9,42,1,5,34,6,1,31,30,1,541,35,2859,0.0101400005817413,81,0.0123500001430511,1.0200888324757,1.59498740892943,39.8199309025934,564.082880622012,42
"278",2020-12-03,8796,566,380,40,44,38,0,6,31,3,1,33,32,1,544,31,3327,0.0102199995517731,202,0,0.963500666158941,1.53687099953329,36.8493577258524,563.249563639757,38
"279",2020-12-04,8838,569,382,54,43.7,42,1,5,32,2,1,31,30,2,546,33,2994,0.0110199999809265,165,0.0121200001239777,1.10774548791865,1.46173385986907,37.8156313482314,565.821037489202,42
"280",2020-12-05,8873,558,382,45,41.6,35,3,2,29,1,1,31,30,0,547,32,2277,0.0184500002861023,209,0,1.68988940673592,1.54426069175673,33.7272646623367,553.244177549496,35
"281",2020-12-06,8912,551,383,33,43,39,0,7,30,1,2,31,29,1,548,30,1397,0.0157500004768372,20,0,1.55276998349623,1.42070035300659,36.7650575290196,546.684889949659,39
"282",2020-12-07,8965,553,384,24,40,53,0,4,44,2,1,30,29,1,550,44,1068,0.0168499994277954,25,0.04,1.73795053878184,1.3583859681456,47.6143234450268,548.152746934087,53
"283",2020-12-08,9012,558,384,58,43.4,47,1,1,44,0,1,27,26,0,550,45,2367,0.01942999958992,69,0,1.88796424586785,1.4228441659193,45.5715112446518,552.686739433682,47
"284",2020-12-09,9067,569,386,39,41.9,55,2,3,48,1,3,24,21,2,551,50,2911,0.00962000012397766,167,0.00598999977111816,0.942305078709412,1.41173220109555,52.7623736011961,566.295811581612,55
"285",2020-12-10,9111,567,386,57,44.3,44,2,0,42,1,3,23,20,0,552,44,3091,0.0139100003242493,252,0.00397000014781952,1.3160709255012,1.46209938100158,43.7079446800578,563.23646894529,44
"286",2020-12-11,9150,551,386,49,43.6,39,6,2,30,1,2,23,21,0,553,36,3047,0.0118099999427795,32,0,1.16872587936503,1.47081086549392,37.7877985672712,547.752139182401,39
"287",2020-12-12,9179,536,387,56,45.1,29,2,5,22,0,2,20,18,1,553,24,2616,0.0156700003147125,24,0,1.5527545766397,1.45122017548018,28.812047888128,531.802402834859,29
"288",2020-12-13,9219,534,388,28,44.4,40,5,2,33,0,2,19,17,1,553,38,1502,0.0119799995422363,47,0,1.16165005244926,1.39534589961632,39.7773657057552,530.871402286139,40
"289",2020-12-14,9261,531,388,19,43.7,42,3,4,35,2,2,20,18,0,555,38,917,0.0174500000476837,20,0,1.70775347318313,1.39103203310222,41.6727030757287,526.426456137157,42
"290",2020-12-15,9309,541,389,51,42.7,48,2,7,38,1,1,20,19,1,556,40,2079,0.0134700000286102,49,0,1.31598355542672,1.30932050589635,46.7345127897734,537.409285481685,48
"291",2020-12-16,9363,557,389,54,44.9,54,3,4,46,0,1,18,17,0,556,49,2312,0.0168700003623962,94,0,1.62109064164007,1.4062898720293,52.5993764002646,552.445972549947,54
"292",2020-12-17,9400,552,390,60,45.3,37,1,5,29,1,0,17,17,1,557,30,3207,0.0134099996089935,83,0.0241000008583069,1.36796865706023,1.41370383368059,34.7930189661511,548.191548977181,37
"293",2020-12-18,9441,541,390,23,41.6,41,3,4,34,0,0,16,16,0,557,37,3298,0.00727999985218048,170,0.00587999999523163,0.72113724082124,1.34976259960291,40.8654285914465,539.032347783043,41
"294",2020-12-19,9480,538,390,46,40.1,39,1,7,28,3,0,19,19,0,560,29,2799,0.0117900002002716,140,0,1.12283805922287,1.28834595425765,35.835771595761,534.953279948945,39
"295",2020-12-20,9524,533,390,24,39.6,44,5,2,34,0,0,16,16,0,560,39,1360,0.0161800003051758,51,0,1.55951810170369,1.34518424700828,40.6932474530539,528.807715191737,44
"296",2020-12-21,9598,553,390,28,40.9,74,7,8,59,1,0,15,15,0,561,66,1365,0.00658999979496002,32,0.03125,0.715486737302823,1.20343185616824,73.7618345972906,551.004462610632,74
"297",2020-12-22,9681,596,390,66,43,83,5,7,69,2,0,15,15,0,563,74,3021,0.0225099992752075,48,0,2.21579367254487,1.33197615861369,80.1730215590069,589.339470934704,83
"298",2020-12-23,9781,663,390,53,42.9,100,5,6,88,1,1,13,12,0,564,93,2652,0.0199800002574921,199,0.0150800001621246,1.96379799070964,1.38093435133791,98.0788870033698,656.433355733701,100
"299",2020-12-24,9855,692,390,56,42.3,74,11,5,56,2,1,13,12,0,566,67,3469,0.01557000041008,144,0,1.49494413015686,1.39907370463743,71.4948353930817,686.782478985262,74
"300",2020-12-25,9918,721,390,52,46.4,63,6,2,54,0,1,10,9,0,566,60,2537,0.0295600008964539,161,0,2.77960423551903,1.69314041816568,61.1588617832886,710.892322429184,63
"301",2020-12-26,10011,763,390,86,52.1,93,5,4,83,2,2,12,10,0,568,88,951,0.0199800002574921,50,0,1.89819982466283,1.80390638465711,91.1575235857519,755.695346544644,93
"302",2020-12-27,10122,828,391,35,53.7,111,8,6,95,2,4,12,8,1,570,103,1480,0.0270300006866455,32,0.0625,2.77806885028012,1.97798506302517,107.55684366607,816.398704422387,111
"303",2020-12-28,10256,924,391,65,59,134,15,7,110,1,2,13,11,0,571,125,1188,0.04125,39,0.0256399989128113,4.07538385962507,2.45797036621406,129.430718532175,905.007871389836,134
"304",2020-12-29,10376,1000,391,112,65.6,120,5,15,100,3,4,12,8,0,574,105,1880,0.0505299997329712,25,0.04,5.03918107600976,2.8613114238519,117.331406562436,974.584824404152,120
"305",2020-12-30,10513,1091,391,88,70.6,137,12,10,115,3,5,13,8,0,577,127,2458,0.0573600006103516,62,0,5.59487625000969,3.38003688946619,133.416335403779,1060.21434587026,137
"306",2020-12-31,10639,1179,391,147,83.6,126,0,9,117,2,5,13,8,0,579,117,2652,0.0331800007820129,144,0,3.14711595400209,3.6160614357298,124.142915109411,1160.28629841022,126
"307",2021-01-01,10756,1235,392,88,88.7,117,0,5,111,2,6,13,7,1,581,111,2759,0.0391400003433228,134,0.0149300003051758,3.80186246070242,3.76209832504171,113.871603527725,1211.31919240307,117
"308",2021-01-02,10868,1293,392,133,95.4,112,4,8,100,2,6,15,9,0,583,104,2369,0.0295499992370605,431,0,2.50014100687844,3.84808992250108,110.688612641309,1276.69592447319,112
"309",2021-01-03,10991,1320,393,107,105.7,123,0,5,118,3,5,18,13,1,586,118,1516,0.0600299978256226,126,0.0238100004196167,5.72506313986087,4.26908910672691,119.592817171947,1281.885751415,123
"310",2021-01-04,11167,1432,393,115,112.9,176,5,30,141,5,8,21,13,0,591,146,1386,0.0533900022506714,155,0.00644999980926514,4.86685873393035,4.38215694591337,172.416274420632,1396.85003404346,176
"311",2021-01-05,11310,1508,395,105,111.9,143,2,19,122,6,8,23,15,2,597,124,2417,0.0575099992752075,97,0.0103100001811981,5.56888378145397,4.45782876097683,139.517244474169,1465.64519892779,143
"312",2021-01-06,11494,1604,395,132,118.1,184,11,42,130,7,7,28,21,0,604,141,2627,0.0513899993896484,211,0.0142200005054474,4.86264793880394,4.35322471651887,179.541999193926,1564.66217522736,184
"313",2021-01-07,11610,1638,395,188,124,116,2,7,106,6,9,32,23,0,610,108,2311,0.048899998664856,91,0.0109899997711182,4.74637747267502,4.58169064775786,112.414650985942,1598.78887328679,116
"314",2021-01-08,11743,1670,395,186,138,133,6,13,113,0,11,30,19,0,610,119,2661,0.0368300008773804,249,0,3.36785678126148,4.51968983640915,129.97868626823,1641.63366443651,133
"315",2021-01-09,11843,1681,397,153,140.9,100,6,2,92,4,11,30,19,2,614,98,3020,0.0324499988555908,375,0.00266999989748001,2.91606027998348,4.57910687542416,98.5586955640798,1656.27721676753,100
"316",2021-01-10,11936,1666,397,120,142.7,93,5,3,83,5,11,34,23,0,619,88,1824,0.0509899997711182,78,0,4.88989272252994,4.45979681580545,88.8297230705589,1624.91271176763,93
"317",2021-01-11,12100,1717,397,66,135.7,164,2,25,135,3,13,34,21,0,622,137,1608,0.0342000007629395,115,0,3.1917354165297,4.22049348474822,159.794634379378,1689.36049072548,164
"318",2021-01-12,12240,1744,398,160,143.6,140,1,22,115,4,13,35,22,1,626,116,2211,0.0705600023269653,74,0.0135099995136261,6.87124311198813,4.40654481768167,133.979996288329,1683.56132350729,140
"319",2021-01-13,12329,1732,402,172,149.3,89,1,9,76,2,11,34,23,4,628,77,2532,0.0375200009346008,173,0.0115600001811981,3.58597125315181,4.22416243401708,84.6073862492045,1700.67523355353,89
"320",2021-01-14,12421,1720,402,130,141,92,2,14,75,9,10,41,31,0,637,77,2581,0.0337100005149841,146,0,3.19052113418313,4.00189724280395,89.7609595030183,1692.32273175573,92
"321",2021-01-15,12517,1689,404,144,135,96,6,7,81,5,11,41,30,2,642,87,2923,0.0372900009155273,206,0.00485000014305115,3.51542897748658,4.02297898512182,92.4574802578711,1659.05384086833,96
"322",2021-01-16,12578,1640,405,119,130.1,61,0,1,58,2,9,39,30,1,644,58,2470,0.0323900008201599,289,0,2.89972098679938,4.02064480038124,58.1517627203871,1616.01535967991,61
"323",2021-01-17,12658,1579,407,74,123.6,80,2,3,72,2,9,39,30,2,646,74,2036,0.026029999256134,32,0,2.5627213967838,3.68819175384607,76.0435412052703,1558.59123733948,80
"324",2021-01-18,12779,1600,408,64,123.3,121,2,45,72,7,10,43,33,1,653,74,1021,0.0391799998283386,48,0,3.74207481990026,3.7668116686133,117.603382959801,1569.80287480652,121
"325",2021-01-19,12853,1541,415,81,112,74,3,24,47,8,9,45,36,7,661,50,2337,0.0410799980163574,89,0,3.95729412053699,3.35053324126313,73.002066769969,1510.24369785045,74
"326",2021-01-20,12914,1499,415,166,111.1,61,1,8,50,2,7,37,30,0,663,51,3065,0.0225099992752075,163,0.00612999975681305,2.16828803404187,3.14800706710457,58.442274759507,1482.60725224512,61
"327",2021-01-21,12985,1468,417,81,104.1,71,1,9,60,3,7,37,30,2,666,61,2636,0.0242799997329712,117,0,2.32481217929938,3.02433435926404,69.2847615433431,1450.78737615783,71
"328",2021-01-22,13064,1436,418,95,97.1,79,1,3,74,5,6,37,31,1,671,75,2311,0.0307200002670288,111,0.00901000022888184,2.97250332958338,2.94677355242072,76.8756105465192,1414.47168993069,79
"329",2021-01-23,13112,1370,418,84,92.1,48,1,4,40,4,9,39,30,0,675,41,2122,0.0329900002479553,276,0,2.91929860409346,2.9495703548913,44.3963356532847,1349.82877670732,48
"330",2021-01-24,13158,1286,419,44,87.9,46,2,9,35,2,8,37,29,1,677,37,1247,0.0224499988555908,36,0,2.18200690357925,2.8951825701478,45.5928157279,1271.84759529944,46
"331",2021-01-25,13221,1227,419,29,82.9,63,1,18,43,4,7,38,31,0,681,44,825,0.0206100010871887,48,0,1.94768051511234,2.63884052660667,61.5677813064902,1214.94699234235,63
"332",2021-01-26,13283,1164,420,74,81.9,62,1,19,40,8,5,40,35,1,689,41,2354,0.024210000038147,79,0,2.3423896461076,2.40813988740247,59.5156312158381,1150.24865207892,62
"333",2021-01-27,13361,1123,422,80,69.6,78,0,27,50,1,4,30,26,2,690,50,2800,0.0196399998664856,175,0.00570999979972839,1.88205880978528,2.36724999822296,76.5253905901484,1112.34027265473,78
"334",2021-01-28,13399,1062,422,66,67.4,38,1,3,33,3,5,30,25,0,693,34,2355,0.0212299990653992,209,0.0287100005149841,2.18397183723271,2.34712994935629,36.6254937231502,1050.30218629369,38
"335",2021-01-29,13428,959,422,73,64.3,29,1,2,26,3,4,31,27,0,696,27,2847,0.0122899997234344,180,0.00555999994277954,1.18898015204223,2.09234092399327,28.8380908028537,953.249225182841,29
"336",2021-01-30,13447,862,423,42,58.3,19,1,6,12,2,5,33,28,1,698,13,2155,0.0157799994945526,216,0,1.43424288953019,1.88019010762709,18.9059629042198,855.764617187496,19
"337",2021-01-31,13490,804,424,25,55.6,43,3,5,35,4,6,32,26,1,702,38,922,0.0195200002193451,24,0,1.90247782264653,1.84025738177955,42.6353834733031,796.285481908835,43
"338",2021-02-01,13530,713,424,27,55.3,40,6,7,25,4,5,29,24,0,706,31,548,0.0292000007629395,29,0,2.77324097367259,1.9581945901453,37.5664068103879,703.027356638921,40
"339",2021-02-02,13572,650,425,59,53.1,42,4,5,31,3,5,27,22,1,709,35,2439,0.0221399998664856,107,0.0280399990081787,2.23879574109322,1.94339546085754,39.604801155015,642.66059287885,42
"340",2021-02-03,13635,635,425,54,49.4,63,4,22,36,2,4,26,22,0,711,40,2865,0.0129100000858307,212,0,1.20205233168362,1.84625167827158,61.7574973343936,631.150270183499,63
"341",2021-02-04,13717,637,425,51,47.3,82,3,43,33,2,5,25,20,0,713,36,2814,0.0127900004386902,90,0,1.23936161275738,1.71130736048939,78.7749734864782,633.018280857962,82
"342",2021-02-05,13774,635,427,72,47.1,57,1,8,47,2,5,21,16,2,715,48,2435,0.0160199999809265,149,0,1.50962461120573,1.75711371179847,55.6345370503766,630.16522972894,57
"343",2021-02-06,13799,604,427,61,49.9,25,1,4,19,3,6,21,15,0,718,20,2369,0.0143499994277954,205,0.0146300005912781,1.43722994427581,1.75754043390498,23.8550262399608,599.621792446816,25
"344",2021-02-07,13824,559,429,33,51,25,1,2,19,3,4,23,19,2,721,20,1004,0.0249000000953674,75,0,2.31692308579693,1.81674690006933,21.7662913629044,552.467843593179,25
"345",2021-02-08,13871,556,431,23,50.4,47,1,7,38,2,5,21,16,2,723,39,852,0.0140799999237061,29,0,1.36165266004513,1.61509142669397,45.7321669937217,552.181662782289,47
"346",2021-02-09,13926,575,431,43,48.1,55,5,8,39,0,2,18,16,0,723,44,2244,0.0178299999237061,149,0,1.67198160588368,1.5341179788069,51.628962912726,570.151219882215,55
"347",2021-02-10,13983,592,432,41,46.3,57,0,6,50,3,4,19,15,1,726,50,2791,0.0125399994850159,100,0,1.21062395581734,1.53534249654028,55.6947101130765,588.385367738826,57
"348",2021-02-11,14043,618,433,51,46.3,60,1,11,46,1,3,16,13,1,727,47,2563,0.0152199995517731,58,0,1.48831968146488,1.57090793492707,57.6472010913278,613.361069668949,60
"349",2021-02-12,14094,621,435,52,43.4,51,0,8,41,3,2,16,14,2,730,41,2612,0.0157000005245209,173,0,1.47247401687786,1.56560070716595,48.6955158803531,616.38817955364,51
"350",2021-02-13,14127,620,435,46,41.3,33,0,3,29,6,2,21,19,0,736,29,2099,0.0219199991226196,46,0.0217400002479553,2.19161390068926,1.67336984379644,31.6794504330683,613.146871327668,33
"351",2021-02-14,14168,594,437,48,43.4,41,0,4,35,4,2,21,19,2,740,35,1175,0.0170200002193451,10,0,1.6876371525511,1.58347185333275,38.702093299,588.944097703029,41
"352",2021-02-15,14230,616,438,34,45,62,2,8,51,4,2,23,21,1,744,53,867,0.0265300011634827,26,0,2.57575711184093,1.75691534644643,60.311484173714,607.997627377506,62
"353",2021-02-16,14281,611,438,61,47.6,51,3,13,32,3,2,24,22,0,747,35,1561,0.0333100008964539,23,0,3.28263329541442,1.98700844495083,47.4205398629964,600.884281608308,51
"354",2021-02-17,14338,627,439,50,48.9,57,5,6,44,2,2,25,23,1,749,49,2063,0.0184200000762939,222,0,1.66303983183345,2.0516392843817,54.5890094071123,621.740997923661,57
"355",2021-02-18,14410,643,439,68,51.3,72,3,12,53,3,3,26,23,0,752,56,2348,0.0212899994850159,116,0,2.02877105482213,2.12884662343274,67.427000533983,636.420738274127,72
"356",2021-02-19,14464,648,440,58,52.1,54,2,16,33,1,3,26,23,1,753,35,2576,0.0151400005817413,96,0,1.45960484650321,2.12700817052207,50.7423462360211,643.229724598334,54
"357",2021-02-20,14512,626,440,66,55,48,0,3,44,4,3,26,23,0,757,44,2384,0.0255900001525879,68,0,2.48803264126303,2.16935370488975,46.4478692941309,618.144685866498,48
"358",2021-02-21,14552,612,440,53,55.7,40,0,7,31,2,4,24,20,0,759,31,1000,0.03,28,0,2.91828793774319,2.34516095991719,37.5437288763778,602.992324914297,40
"359",2021-02-22,14617,627,440,32,55.4,65,0,11,54,1,6,23,17,0,760,54,863,0.0150600004196167,66,0,1.39900757396439,2.17705388307769,64.6189806991932,622.575942562854,65
"360",2021-02-23,14672,633,440,47,53.4,55,0,7,47,3,6,25,19,0,763,47,2036,0.019650000333786,84,0,1.88714154149001,1.97769791823135,53.5526623180227,626.975218027838,55
"361",2021-02-24,14719,639,441,60,54.9,47,2,10,35,1,6,24,18,1,764,37,2874,0.0187899994850159,41,0,1.85257147581254,2.00477386737122,46.6542916676136,633.029523665002,47
"362",2021-02-25,14752,635,441,44,51.4,33,1,5,25,1,6,23,17,0,765,26,2376,0.0185199999809265,128,0.00781000018119812,1.79725239528254,1.97169977315127,30.7643238856261,629.244064129715,33
"363",2021-02-26,14817,638,441,56,51.1,65,5,12,43,1,6,21,15,0,766,48,2639,0.0181900000572205,181,0,1.70224858691506,2.00636316463868,59.5879049765428,632.522570313215,65
"364",2021-02-27,14864,644,442,71,51.9,47,0,5,34,3,6,23,17,1,769,34,2535,0.0209100008010864,47,0.0212800002098083,2.09167358794017,1.94974044273542,38.6413209756418,637.206197303332,47
"365",2021-02-28,14930,656,442,50,51.4,66,2,9,54,7,6,28,22,0,776,56,1552,0.0257699990272522,94,0,2.42983222905804,1.87996105578039,64.3137261267348,647.960791770322,66
"366",2021-03-01,15008,672,442,55,54.7,78,4,7,65,3,6,29,23,0,779,69,996,0.0291199994087219,45,0,2.78612098089213,2.07812011391293,75.030423207742,662.557165153661,78
"367",2021-03-02,15073,682,443,62,56.9,65,1,6,57,3,4,29,25,1,782,58,2006,0.0259200000762939,41,0,2.54008403287961,2.17139761268287,63.2569650735893,673.262934141171,65
"368",2021-03-03,15133,693,443,65,57.6,60,0,5,51,6,5,32,27,0,788,51,2676,0.0209299993515015,109,0,2.01108360016581,2.19404220187619,55.482710752933,685.970951995737,60
"369",2021-03-04,15191,690,443,61,60,58,3,3,51,1,5,31,26,0,789,54,2414,0.0202999997138977,225,0.00444000005722046,1.89477829944008,2.2079744738987,56.4839576880983,683.406126014589,58
"370",2021-03-05,15262,692,444,52,59.4,71,1,9,57,1,2,28,26,1,790,58,2440,0.0188499999046326,154,0,1.77309174122218,2.218094924514,66.481328540944,685.811712936781,71
"371",2021-03-06,15319,707,445,46,55.9,57,3,3,48,0,2,26,24,1,790,51,1957,0.0209500002861023,25,0,2.06857470029779,2.21479508342224,53.4679229400853,699.623951345888,57
"372",2021-03-07,15358,697,446,55,56.6,39,1,0,37,2,5,25,20,1,792,38,1752,0.0194099998474121,16,0.0625,1.97999545999242,2.15053268784143,37.6205269470665,690.039665318562,39
"373",2021-03-08,15444,742,447,39,54.3,86,1,10,66,6,4,29,25,1,798,67,1170,0.0205100011825562,142,0,1.82901687374929,2.01380352967817,76.3819470765255,735.155294489282,86
"374",2021-03-09,15500,747,447,69,55.3,56,0,8,46,1,3,27,24,0,799,46,2105,0.0318300008773804,57,0,3.09908195406502,2.0936603755618,53.2810080249985,735.324195536389,56
"375",2021-03-10,15582,772,447,76,56.9,82,4,8,67,0,2,24,22,0,799,71,2655,0.0180799996852875,173,0,1.69739742448509,2.04884806475027,78.3921799277809,765.391026820378,82
"376",2021-03-11,15643,770,450,73,58.6,61,1,6,52,1,2,20,18,3,800,53,2321,0.0280100011825562,86,0,2.70092283941474,2.16401157046093,58.2780265996489,759.510952485465,61
"377",2021-03-12,15725,775,450,96,64.9,82,3,4,70,2,2,17,15,0,802,73,2361,0.0228699994087219,133,0,2.16503883736938,2.22000401276768,76.2028836785715,766.537463710862,82
"378",2021-03-13,15794,794,450,56,66.3,69,4,4,55,5,4,22,18,0,807,59,2353,0.0187000000476837,99,0,1.79449837325448,2.18085025176149,62.4660160165089,786.813842662848,69
"379",2021-03-14,15859,815,450,65,67.7,65,1,7,52,2,3,23,20,0,809,53,1535,0.0299699997901916,36,0,2.92832270387932,2.31632557231676,59.2172412077113,802.963237439335,65
"380",2021-03-15,15960,855,451,59,70.6,101,2,4,92,4,5,25,20,1,813,94,1000,0.0320000004768372,13,0,3.15893390689409,2.50631371990887,96.5023803033729,841.378033610466,101
"381",2021-03-16,16045,869,452,85,72.9,85,4,5,73,5,6,27,21,1,818,77,1583,0.0341100001335144,9,0,3.39171672181867,2.54811868673083,80.6828250947477,854.134740355009,85
"382",2021-03-17,16129,892,453,78,73.1,84,3,5,73,3,5,27,22,1,821,76,2842,0.0267400002479553,175,0,2.51889561500461,2.66547557109076,80.0344896962034,880.667958013334,84
"383",2021-03-18,16229,935,454,63,71.7,100,2,3,91,2,5,24,19,1,823,93,2566,0.0284500002861023,161,0,2.67703339692477,2.66206279359219,94.7443462790033,922.375954525463,100
"384",2021-03-19,16358,989,456,118,74.9,129,6,6,109,2,4,24,20,2,825,115,2615,0.0382399988174438,97,0,3.6872270246171,2.87951824891329,118.861393567512,970.607984680604,129
"385",2021-03-20,16458,1039,457,84,78.9,100,4,4,87,4,4,27,23,1,829,91,1997,0.0435699987411499,151,0.00662000000476837,4.09724895189927,3.20848261729112,93.1195278954742,1017.52955476261,100
"386",2021-03-21,16543,1068,458,88,82.1,85,5,1,78,4,4,29,25,1,833,83,1306,0.0421099996566772,87,0,3.94800140356213,3.35415100296009,82.3473208771251,1046.7342011659,85
"387",2021-03-22,16694,1145,459,55,81.6,151,5,5,137,4,7,30,23,1,837,142,1150,0.0547800016403198,131,0,4.91779874210521,3.60541740799025,143.477976526338,1116.60058537082,151
"388",2021-03-23,16816,1179,460,109,85,122,2,0,118,5,9,31,22,1,842,120,1966,0.0350999999046326,153,0,3.25656440832976,3.58610993463469,118.029056982987,1159.63548485784,122
"389",2021-03-24,16962,1261,460,90,86.7,146,6,3,131,4,9,33,24,0,846,137,3106,0.0457200002670288,47,0,4.50384779033909,3.86967453111105,136.888015520995,1232.35611366405,146
"390",2021-03-25,17117,1348,461,126,95.7,155,7,5,137,8,10,40,30,1,854,144,3005,0.0379399991035461,282,0,3.46850311244771,3.98274163332861,146.480944529831,1324.41884184869,155
"391",2021-03-26,17265,1433,462,107,94.1,148,9,2,130,4,11,42,31,1,858,139,2390,0.0673600006103516,117,0,6.42163547900839,4.37337141252737,136.49812326088,1386.58856570389,148
"392",2021-03-27,17395,1500,464,141,102.3,130,6,4,114,5,13,44,31,2,863,120,2474,0.0630600023269653,117,0,6.02124452940611,4.64822792359977,120.355812945506,1454.44766181882,130
"393",2021-03-28,17527,1554,465,144,110.3,132,4,5,119,5,13,45,32,1,868,123,2462,0.0755499982833862,157,0,7.10210369506288,5.09881396524274,123.594195008308,1498.33641498301,132
"394",2021-03-29,17735,1703,465,117,119.1,208,7,1,188,4,12,47,35,0,872,195,1632,0.0778200006484985,40,0,7.59582781449459,5.48138954701265,188.529616919116,1637.75865442694,208
"395",2021-03-30,17943,1832,466,167,127.4,208,8,5,187,6,12,48,36,1,878,195,1967,0.0406699991226196,64,0,3.93884235717345,5.57885782541889,196.126207436252,1795.60621550366,208
"396",2021-03-31,18145,1930,467,168,138.6,202,5,6,186,8,14,54,40,1,886,191,3003,0.0739300012588501,224,0,6.87982007376284,5.91828243733657,190.372593675922,1863.03196751062,202
"397",2021-04-01,18373,2050,468,146,141.4,228,10,5,198,4,14,52,38,1,890,208,2617,0.0664900016784668,100,0.01,6.44108702217695,6.3429372815836,206.24297303722,1983.40430156876,228
"398",2021-04-02,18557,2128,469,252,162.1,184,13,6,151,6,14,56,42,1,896,164,3125,0.0927999973297119,99,0,8.99503696201457,6.7105660648702,162.559879823543,2031.45990405182,184
"399",2021-04-03,18781,2282,469,227,174.4,224,12,3,201,12,13,61,48,0,908,213,2869,0.0972500038146973,36,0,9.60448402562363,7.2224574214727,205.682207437332,2171.45914259151,224
"400",2021-04-04,18984,2415,470,157,176.3,203,7,4,188,12,15,64,49,1,920,195,1811,0.0894499969482422,139,0,8.30738176785982,7.39464000330084,190.829814245309,2313.81539180729,203
"401",2021-04-05,19216,2505,471,190,186.7,232,5,4,219,5,17,67,50,1,925,224,2025,0.0972799968719482,162,0,9.00740711777298,7.59629418948346,217.823909491584,2391.20041641258,232
"402",2021-04-06,19432,2581,472,160,185.7,216,5,5,194,10,19,71,52,1,935,199,1707,0.108380002975464,83,0,10.3354561496713,8.5100961598403,193.626725382549,2446.46019202191,216
"403",2021-04-07,19666,2656,473,232,194.9,234,3,5,217,12,23,77,54,1,947,220,3331,0.0894600009918213,44,0,8.82937076455575,8.78860340138215,215.203169701705,2537.72553967149,234
"404",2021-04-08,19914,2777,474,183,200.1,248,10,4,223,10,29,84,55,1,957,233,3348,0.080939998626709,194,0.0103100001811981,7.7071500688135,8.96946955090166,227.943030887882,2669.0549217839,248
"405",2021-04-09,20233,2951,476,289,205.4,319,6,2,307,13,30,88,58,2,970,313,3384,0.102840003967285,158,0,9.82525616672199,9.08807229443129,299.489658143603,2804.76671304081,319
"406",2021-04-10,20539,3119,479,466,239.6,306,10,4,283,14,26,92,66,3,984,293,3166,0.0827499961853027,97,0,8.02900667859848,8.86300410199912,285.135140774856,2992.69796613234,306
"407",2021-04-11,20819,3268,479,267,255.3,280,6,2,264,12,29,99,70,0,996,270,2685,0.137430000305176,30,0.0333299994468689,13.6279724052598,9.62308847877055,253.442128642118,3043.38102371274,242
"408",2021-04-12,21165,3398,480,321,274,346,13,5,324,17,27,101,74,1,1013,337,2118,0.0797900009155273,107,0,7.59529087366683,9.42135758675538,329.090558268902,3267.83298812382,328
"409",2021-04-13,21467,3499,481,341,299.9,302,15,2,277,11,28,104,76,1,1024,292,2660,0.0748099994659424,178,0,7.01178994289664,8.94654812864471,283.673696176828,3375.26117439288,286
"410",2021-04-14,21769,3610,483,308,310.7,302,12,10,277,13,28,102,74,2,1037,289,3860,0.148959999084473,95,0,14.5381946009119,9.7620943909813,277.809486993415,3345.30189635374,296
"411",2021-04-15,22007,3631,483,231,317.6,238,14,2,221,19,29,110,81,0,1056,235,3833,0.116619997024536,97,0,11.3741589973294,10.2859528093407,223.519055914882,3422.70507245505,238
"412",2021-04-16,22249,3690,484,333,323.9,242,4,9,224,15,24,113,89,1,1071,228,2943,0.112469997406006,243,0,10.389177726487,10.3665130321643,225.05326657864,3496.65155120693,255
"413",2021-04-17,22398,3625,484,368,309.9,149,5,8,135,15,23,121,98,0,1086,140,2923,0.0992099952697754,121,0.00825999975204468,9.55947030694977,10.5851506933573,141.250136125183,3450.22673895563,193
"414",2021-04-18,22515,3542,484,251,307.6,117,1,7,108,9,21,118,97,0,1095,109,1941,0.0618200016021729,187,0.0107000005245209,5.73277834623604,9.45726582778251,112.84844566855,3439.58894089911,189
"415",2021-04-19,22652,3450,484,197,289.9,137,0,6,131,22,21,116,95,0,1117,131,2051,0.10043999671936,88,0.0340899991989136,9.77103100518525,9.76808584657086,130.544277747623,3279.98288724656,205
"416",2021-04-20,22794,3372,485,188,268,142,4,2,136,14,26,118,92,1,1131,140,2756,0.0976099967956543,221,0,9.03638398282913,10.0573135665612,135.619483104589,3218.32069306196,191
"417",2021-04-21,23009,3355,486,220,255.4,215,2,2,209,9,25,112,87,1,1140,211,2431,0.107360000610352,235,0.0212800002098083,9.97723036508138,9.40574724715685,202.382418450679,3186.17542133662,228
"418",2021-04-22,23173,3267,489,236,256.1,164,0,1,163,9,21,107,86,3,1149,163,2334,0.181229991912842,208,0.00481000006198883,16.679436708791,10.1636440630799,150.287958014778,2992.17029959681,191
"419",2021-04-23,23313,3078,489,189,235.6,140,0,0,140,3,25,104,79,0,1152,140,NA,NA,NA,NA,NA,NA,NA,NA,204
"420",2021-04-24,23313,2787,490,132,201.9,0,0,0,0,0,25,104,79,1,1152,0,NA,NA,NA,NA,NA,NA,NA,NA,196
