"","date","observed_cumulative_cases","observed_active_cases","observed_cumulative_deaths","observed_new_cases","observed_daily_average_cases","observed_new_episodes","observed_new_cases_community_outbreak","observed_new_cases_institution_outbreak","observed_new_cases_sporadic","observed_new_ICU_p_acute_care","observed_census_ICU","observed_census_ICU_p_acute_care","observed_census_acute_care","observed_new_deaths","cumulative_hosp","observed_new_community_cases","num_non_ltch_tests","non_ltch_pct_positivity","num_ltch_tests","ltch_pct_positivity","observed_pct_positivity","pct_positivity_7_day","adjusted_new_episodes","adjusted_active_cases","adjusted_episode_cases"
"1",2020-03-01,7,7,0,0,0,2,0,0,2,0,0,1,1,0,0,2,NA,NA,NA,NA,NA,NA,NA,NA,2
"2",2020-03-02,10,10,0,0,0,3,2,0,1,0,0,1,1,0,0,3,NA,NA,NA,NA,NA,NA,NA,NA,3
"3",2020-03-03,11,11,0,0,0,1,0,0,1,0,0,1,1,0,0,1,NA,NA,NA,NA,NA,NA,NA,NA,1
"4",2020-03-04,12,12,0,0,0,1,0,0,1,0,0,1,1,0,0,1,NA,NA,NA,NA,NA,NA,NA,NA,1
"5",2020-03-05,18,18,0,0,0,6,2,0,4,0,0,1,1,0,0,6,NA,NA,NA,NA,NA,NA,NA,NA,6
"6",2020-03-06,23,23,0,0,0,5,0,1,4,0,0,1,1,0,0,4,NA,NA,NA,NA,NA,NA,NA,NA,5
"7",2020-03-07,27,27,0,0,0,4,0,0,4,0,0,1,1,0,0,4,NA,NA,NA,NA,NA,NA,NA,NA,4
"8",2020-03-08,36,36,0,0,0,9,1,0,8,0,0,1,1,0,0,9,NA,NA,NA,NA,NA,NA,NA,NA,9
"9",2020-03-09,45,45,0,1,0.1,9,0,0,9,0,0,1,1,0,0,9,NA,NA,NA,NA,NA,NA,NA,NA,9
"10",2020-03-10,52,52,0,0,0.1,7,1,0,6,0,0,1,1,0,0,7,NA,NA,NA,NA,NA,NA,NA,NA,7
"11",2020-03-11,61,61,0,0,0.1,9,0,0,9,0,0,1,1,0,0,9,NA,NA,NA,NA,NA,NA,NA,NA,9
"12",2020-03-12,75,75,0,3,0.6,14,1,0,13,0,0,1,1,0,0,14,NA,NA,NA,NA,NA,NA,NA,NA,14
"13",2020-03-13,97,97,0,1,0.7,22,2,2,18,0,0,1,1,0,0,20,NA,NA,NA,NA,NA,NA,NA,NA,22
"14",2020-03-14,115,115,0,4,1.3,18,1,1,16,1,0,2,2,0,1,17,NA,NA,NA,NA,NA,NA,NA,NA,18
"15",2020-03-15,142,142,0,4,1.9,27,1,0,26,0,0,2,2,0,1,27,NA,NA,NA,NA,NA,NA,NA,NA,27
"16",2020-03-16,157,157,0,0,1.7,15,0,0,15,0,0,2,2,0,1,15,NA,NA,NA,NA,NA,NA,NA,NA,15
"17",2020-03-17,180,179,0,5,2.4,23,1,0,22,2,0,4,4,0,3,23,127,0,4,0,0,0,23,179,23
"18",2020-03-18,196,194,0,4,3,16,0,0,16,0,0,3,3,0,3,16,210,0.0190499997138977,1,0,1.89597153550641,0.947985767753204,15.6318404022685,189.536064877506,16
"19",2020-03-19,221,219,0,1,2.7,25,0,0,25,4,0,7,7,0,7,25,110,0.0272699999809265,9,0,2.52075630075791,1.47224261208811,24.2351871056882,212.300239045829,25
"20",2020-03-20,243,241,0,2,2.9,22,1,1,20,3,1,10,9,0,10,21,137,0.00730000019073486,4,0,0.709290798674238,1.28150465873464,21.8192293365595,238.925441433849,22
"21",2020-03-21,263,261,0,4,2.9,20,0,2,18,3,1,10,9,0,13,18,204,0.0147099995613098,3,0,1.44968111618705,1.31513995022512,19.6833136693237,256.408048205194,20
"22",2020-03-22,289,287,0,7,3.3,26,0,1,25,3,5,13,8,0,16,25,159,0.0314499998092651,2,0,3.10593165818208,1.61360523488462,25.0576413196648,276.181722349752,26
"23",2020-03-23,310,308,0,9,4.6,21,1,0,20,4,5,17,12,0,20,21,138,0.0362299990653992,3,0,3.54591480214545,1.88964945877902,20.0962841016893,294.745500158109,21
"24",2020-03-24,328,324,1,8,5,18,1,3,14,3,7,20,13,1,23,15,253,0.0197599995136261,4,0,1.94524508830638,2.16754161425136,17.6458804385765,316.351017473252,18
"25",2020-03-25,351,347,1,8,5.6,23,0,1,22,4,8,23,15,0,27,22,153,0.0588199996948242,2,0,5.80610319568265,2.7261318514194,21.4497856148108,322.548891288152,23
"26",2020-03-26,365,357,1,19,8.1,14,1,3,10,2,7,25,18,0,29,11,274,0.025550000667572,3,0,2.5273285858898,2.72707074929538,13.6626049350226,346.04999652755,14
"27",2020-03-27,382,365,1,27,11.7,17,3,2,12,5,9,26,17,0,34,15,577,0.0294600009918213,4,0,2.92571782655437,3.04370318184968,16.4673915796952,352.039861772584,17
"28",2020-03-28,407,387,2,26,14.9,25,1,1,23,3,8,25,17,1,37,24,367,0.0817399978637695,3,0,8.10772411243336,3.99485218131344,22.6384641922216,348.920235099573,25
"29",2020-03-29,426,399,2,11,15.4,19,5,4,10,7,8,31,23,0,44,15,184,0.0434800004959106,0,0,4.34800004959107,4.1722905229433,18.2084740992863,377.945411041014,19
"30",2020-03-30,451,408,3,48,21,25,8,3,14,4,12,32,20,1,48,22,549,0.0783199977874756,0,0,7.83199977874756,4.7845883767436,22.9088765196524,369.219164546281,25
"31",2020-03-31,468,405,3,51,27.1,17,2,3,12,6,13,34,21,0,54,14,943,0.064689998626709,0,0,6.4689998626709,5.43083905879567,15.9008688686808,373.203706558265,17
"32",2020-04-01,495,408,3,37,31.3,27,6,4,16,3,15,33,18,0,57,22,575,0.0573899984359741,4,0.25,5.87206374795943,5.44026199483521,24.4321743196704,378.923960110252,27
"33",2020-04-02,512,404,6,32,33.1,17,5,4,7,6,14,34,20,3,63,12,107,0.0841100025177002,9,0,7.75842264602924,6.1875611462837,14.8701025937488,365.96012065621,17
"34",2020-04-03,540,410,6,26,33,28,3,4,20,5,14,37,23,0,68,23,217,0.110600004196167,2,0,10.9589958495745,7.33517229242944,23.9409756804384,355.469566477381,28
"35",2020-04-04,557,417,7,18,31.9,17,3,7,6,7,14,43,29,1,75,9,315,0.0253999996185303,3,0,2.51603769806196,6.53635994751924,15.7251827531085,404.266800894025,17
"36",2020-04-05,584,428,8,40,36,27,4,8,13,4,13,43,30,1,79,17,422,0.0663500022888184,5,0.2,6.79149905524153,6.88543123404074,23.598803973092,392.722829440199,27
"37",2020-04-06,603,428,9,40,34.9,19,3,7,9,4,12,44,32,1,83,12,238,0.117650003433228,4,0.25,11.9837606682265,7.47853993253773,17.2547457500148,365.752598417194,19
"38",2020-04-07,626,426,9,25,31.1,23,2,11,10,4,14,45,31,0,87,12,285,0.108769998550415,6,0,10.6527318167932,8.07621592598378,21.4485900551648,370.924946958352,23
"39",2020-04-08,646,429,11,26,29.6,20,1,10,8,5,16,44,28,2,92,9,368,0.0434800004959106,6,0.333330001831055,4.81300005173301,7.92492111223715,18.4742942744757,403.941360416675,20
"40",2020-04-09,682,437,11,25,28.6,36,1,20,13,6,16,47,31,0,98,14,295,0.0949199962615967,5,0,9.33379963239034,8.14997496743159,32.4141181067794,387.4978294759,36
"41",2020-04-10,716,454,11,37,30.1,34,0,20,13,4,16,49,33,0,102,13,331,0.090629997253418,8,0,8.84912362562872,7.84856464972504,31.6038632920975,405.24261035479,34
"42",2020-04-11,760,484,11,31,32,44,0,34,8,6,19,54,35,0,108,8,225,0.102220001220703,11,0.363639984130859,11.4404830932617,9.12348542046786,40.889243964218,416.79925983519,44
"43",2020-04-12,793,499,13,35,31.3,33,0,18,14,1,18,50,32,2,109,14,227,0.101319999694824,12,0.5,12.1337405567887,9.88666277783175,29.9383873444989,425.518234636067,33
"44",2020-04-13,817,506,16,16,27.9,24,0,19,5,3,20,52,32,3,112,5,165,0.0606099987030029,26,0.0384599995613098,5.75948155737672,8.99748004771035,23.6505076069188,470.631369820179,24
"45",2020-04-14,850,506,18,32,28.9,33,0,26,7,5,20,51,31,2,117,7,208,0.0673099994659424,18,0.166669998168945,7.52236276812258,8.55028446932883,32.3609473430947,459.805622229414,33
"46",2020-04-15,879,504,24,60,33.7,29,2,18,9,4,16,51,35,6,121,11,390,0.1,24,0.208330001831055,10.6280000106148,9.38099874916909,27.5811758810542,438.992058550118,29
"47",2020-04-16,949,553,24,21,33.1,70,1,55,13,7,13,53,40,0,128,14,310,0.0354800009727478,11,0,3.42641753942424,8.5370870216025,68.4178262070755,530.004135179481,70
"48",2020-04-17,981,557,26,73,38.3,32,0,26,6,0,13,49,36,2,128,6,378,0.0846599960327148,66,0.5,14.6399726352176,9.36435116582949,30.9339542415502,458.035418757244,32
"49",2020-04-18,1021,579,31,31,38.3,40,0,31,9,1,11,46,35,5,129,9,421,0.0617600011825562,8,0,6.06082995288022,8.59582928863213,39.3379985511301,536.411240122701,40
"50",2020-04-19,1038,582,35,38,38.7,17,0,13,4,5,15,47,32,4,134,4,452,0.0442500019073486,47,0.127659997940063,5.21062540386865,7.60681283821498,16.7470502962871,545.195818109773,17
"51",2020-04-20,1099,618,39,16,38.7,61,1,47,13,3,13,45,32,4,137,14,325,0.0523099994659424,43,0.0232599997520447,4.89155701515467,7.48282361789754,60.1688881264314,581.312347295328,61
"52",2020-04-21,1135,631,47,51,41.4,36,0,26,10,2,11,43,32,8,139,10,543,0.069980001449585,25,0.36,8.27449661745152,7.59027131065882,34.9957868271418,567.634148792648,36
"53",2020-04-22,1176,647,54,35,37.9,41,1,31,9,4,9,45,36,7,143,10,656,0.0243899989128113,122,0.106560001373291,3.7275269221524,6.60448944087848,40.5476182044097,617.730897825304,41
"54",2020-04-23,1221,662,57,50,42,45,0,35,10,5,11,48,37,3,148,10,775,0.0361299991607666,105,0.0285700011253357,3.522795394063,6.61825770582687,44.5724649240244,633.697177970413,45
"55",2020-04-24,1262,669,65,38,37,41,0,36,5,7,10,48,38,8,155,5,517,0.0406199979782104,94,0.106379995346069,5.07369206501887,5.25164619579848,40.6921221530279,627.805944075131,41
"56",2020-04-25,1363,741,78,53,40.1,101,0,95,6,4,9,48,39,13,159,6,557,0.0502699995040894,28,0.0357100009918213,4.95731106864081,5.09400064090713,100.639021153269,696.419112428667,101
"57",2020-04-26,1417,760,87,88,47.3,54,0,41,13,5,9,50,41,9,164,13,358,0.0502799987792969,81,0.0123500001430511,4.32815252268233,4.96793308645194,53.3171422538593,720.079085610234,54
"58",2020-04-27,1478,784,95,87,57.4,61,0,54,7,8,11,56,45,8,172,7,269,0.0632000017166138,80,0.1,7.16355314090805,5.29250396155957,60.3914295536265,715.840110006166,61
"59",2020-04-28,1499,780,103,65,59.4,21,0,14,7,7,13,61,48,8,179,7,503,0.0616300010681152,11,0.272730007171631,6.61477054788909,5.05540023733637,20.4380506732059,717.382789300082,21
"60",2020-04-29,1524,769,111,29,58.6,25,0,17,8,7,13,62,49,8,186,8,668,0.0314400005340576,74,0.148649997711182,4.31294072606172,5.13903078075198,24.5812567612407,728.748306174266,25
"61",2020-04-30,1544,759,122,30,55.7,20,0,10,10,2,11,56,45,11,188,10,603,0.0414599990844727,6,0.333330001831055,4.43355656139956,5.26913951894292,19.4619327183989,718.16069332648,20
"62",2020-05-01,1567,742,135,42,56.3,23,0,16,7,6,11,57,46,13,194,7,516,0.031010000705719,55,0.0909099960327148,3.67797025323123,5.06975068868754,22.6875427661763,708.879533214684,23
"63",2020-05-02,1588,743,139,22,51.9,21,0,15,6,4,12,57,45,4,198,6,508,0.0511800003051758,28,0.0357100009918213,5.03718660126871,5.08116147906296,20.6332048191207,697.578530101113,21
"64",2020-05-03,1607,724,148,23,42.6,19,0,13,6,3,12,52,40,9,201,6,826,0.0205800008773804,231,0.0043299999833107,1.70286761786764,4.70612077837514,18.8760014894521,709.037513060551,19
"65",2020-05-04,1625,721,152,14,32.1,18,0,11,7,6,10,52,42,4,207,7,637,0.0109899997711182,24,0.125,1.51295459216373,3.89889241426881,17.8714688879408,707.761295457904,18
"66",2020-05-05,1650,721,156,29,27,25,0,24,1,3,9,50,41,4,210,1,923,0.0292499995231628,29,0.172409992218018,3.36109656871868,3.4340818458159,24.9592089089451,691.589623349448,25
"67",2020-05-06,1666,694,161,23,26.1,16,0,11,5,4,10,52,42,5,214,5,598,0.0167200005054474,149,0.0134200000762939,1.60617674881196,3.04740127763736,15.9025352282039,680.471889674697,16
"68",2020-05-07,1689,672,167,32,26.4,23,0,16,7,6,10,54,44,6,220,7,813,0.0356699991226196,234,0.0128199994564056,3.05631224063884,2.85065208895726,22.7403549233242,647.074072639121,23
"69",2020-05-08,1702,639,173,16,22.7,13,0,8,5,4,8,54,46,6,224,5,715,0.00978999972343445,127,0.0472399997711182,1.54386339349022,2.54577968042283,12.9063164789042,627.027246003956,13
"70",2020-05-09,1719,623,179,12,21.3,17,0,12,5,5,6,51,45,6,229,5,1100,0.0154499995708466,164,0.0304900002479553,1.74013920637626,2.0747729097239,16.8944062222489,609.843015292219,17
"71",2020-05-10,1731,554,185,25,21.6,12,0,8,4,3,5,52,47,6,232,4,907,0.0176400005817413,316,0.0126600003242493,1.6353262984548,2.06512414980778,11.9206131182716,543.004916880613,12
"72",2020-05-11,1751,535,188,14,21.6,20,0,14,6,1,5,51,46,3,233,6,517,0.00967000007629394,197,0.0152300000190735,1.12040616851561,2.00904580357234,19.9184148581799,527.725324854372,20
"73",2020-05-12,1774,518,193,13,19.3,23,0,17,6,4,6,51,45,5,237,6,835,0.0131700003147125,322,0.00310999989509583,1.03702422031165,1.67703546808562,22.9244865206364,511.480669614944,23
"74",2020-05-13,1795,500,195,21,19,21,0,15,6,2,7,47,40,2,239,6,1249,0.0144099998474121,224,0.0133899998664856,1.42548878340193,1.65122290159847,20.8961995142253,491.349959518778,21
"75",2020-05-14,1809,472,198,25,18,14,0,10,4,2,6,45,39,3,241,4,1046,0.0267700004577637,127,0.0236199998855591,2.6428951802461,1.59216332154237,13.8717007075022,456.860683485257,14
"76",2020-05-15,1829,458,201,17,18.1,20,0,12,8,1,5,44,39,3,242,8,1163,0.012039999961853,137,0.0146000003814697,1.23097846214588,1.54746547420746,19.8804843514387,451.157729119864,20
"77",2020-05-16,1845,438,207,19,19.1,16,0,6,10,1,4,42,38,6,243,10,967,0.0134399998188019,25,0.04,1.4109354662078,1.50043636846911,15.8287654165898,430.499925246632,16
"78",2020-05-17,1857,398,212,15,17.7,12,0,9,3,1,2,42,40,5,244,3,353,0.0254999995231628,10,0.1,2.7552341134095,1.66042319917693,11.8996854122162,384.691598020681,12
"79",2020-05-18,1872,390,213,26,19.4,15,0,8,7,2,1,43,42,1,246,7,376,0.0398900008201599,17,0.0588199996948242,4.07088557333133,2.08192025700774,14.6541631503576,370.731946948493,15
"80",2020-05-19,1884,353,219,23,20.9,12,0,8,4,0,1,40,39,6,246,4,359,0.0390000009536743,31,0.225809993743896,5.38490003805894,2.70304537382879,11.7385901377329,329.930579654931,12
"81",2020-05-20,1899,339,223,17,20.3,15,0,9,6,3,1,41,40,4,249,6,675,0.0296300005912781,36,0.0555600023269653,3.0942912071566,2.94144572007945,14.7746815449052,326.269507287142,15
"82",2020-05-21,1907,325,229,11,18.3,8,0,1,7,0,1,38,37,6,249,7,478,0.0209200000762939,36,0,1.94547860631683,2.8418147809467,7.83472436644669,317.326488442168,8
"83",2020-05-22,1914,309,233,7,16.9,7,0,3,4,1,1,36,35,4,250,4,514,0.00583999991416931,14,0,0.568515143159664,2.74717716394867,6.97240144399715,306.86801154878,7
"84",2020-05-23,1923,305,236,6,15,9,1,3,5,1,0,35,35,3,251,6,582,0.00859000027179718,43,0,0.799900825309753,2.65988650096323,8.94175324618089,302.039123347529,9
"85",2020-05-24,1933,302,237,8,14,10,0,3,7,1,1,36,35,1,252,7,332,0.0150600004196167,25,0.04,1.68064989896716,2.50637447032861,9.85722254876964,295.840172818348,10
"86",2020-05-25,1948,298,240,6,11.1,15,1,7,7,0,1,35,34,3,252,8,401,0.0174600005149841,8,0,1.71184846124906,2.16936916860257,14.8337967028861,291.808927182505,15
"87",2020-05-26,1954,288,243,16,10.1,6,0,2,4,1,1,35,34,3,253,4,1123,0.00800999999046326,41,0.0731699991226196,1.03051545990701,1.54731422886658,5.94997364806507,284.398102660685,6
"88",2020-05-27,1959,261,243,8,8.9,5,0,1,4,1,1,33,32,0,254,4,1150,0.00957000017166138,13,0.0769199991226196,1.03228376491871,1.25274173711831,4.94988780573442,257.730179324171,5
"89",2020-05-28,1963,236,244,4,7.9,4,0,2,2,1,1,31,30,1,255,2,1403,0.00284999996423721,88,0,0.268179071081476,1.01312751779898,3.99349062623829,235.231893896118,4
"90",2020-05-29,1970,226,247,7,7.9,7,0,3,4,2,1,32,31,3,257,4,1380,0.0065200001001358,37,0,0.634975309681539,1.0226218273021,6.96917513657196,224.258395216315,7
"91",2020-05-30,1973,208,248,15,9.1,3,1,1,1,0,1,31,30,1,257,2,1020,0.0127499997615814,119,0,1.1417910234252,1.07146328417574,2.97228588905441,205.117732461659,3
"92",2020-05-31,1977,193,249,10,9.4,4,0,1,3,3,1,34,33,1,260,3,1309,0.00535000026226044,11,0.0909099960327148,0.606300022701422,0.917984730423489,3.97792538334416,191.579866328474,4
"93",2020-06-01,1988,184,250,5,9.3,11,0,5,6,0,1,31,30,1,260,6,763,0.00130999997258186,20,0,0.127653892602805,0.691671220616882,10.9907045665897,183.714940042085,11
"94",2020-06-02,1991,165,251,8,8.1,3,0,1,2,0,1,26,25,1,260,2,858,0.0104900002479553,9,0,1.03811075118174,0.692756262227556,2.9748024674027,162.921203560723,3
"95",2020-06-03,2001,156,251,8,8.1,10,0,7,3,0,0,22,22,0,260,3,1110,0.00449999988079071,141,0,0.399280564962245,0.602327233662347,9.98546269985213,155.244060392311,10
"96",2020-06-04,2008,146,254,8,8.7,7,0,2,5,0,0,20,20,3,260,5,1430,0.00559000015258789,21,0,0.550909732474203,0.642717328147022,6.96657012287372,145.023847587913,7
"97",2020-06-05,2012,137,256,15,9.9,4,0,1,3,1,0,21,21,2,261,3,1366,0.00952000021934509,29,0,0.932209340474939,0.685179332546079,3.96605943746746,135.450047644347,4
"98",2020-06-06,2015,128,257,2,8,3,0,0,3,0,0,21,21,1,261,3,1404,0.000710000023245811,68,0,0.0677201109128478,0.5317406307586,2.99753439645008,127.894800915203,3
"99",2020-06-07,2016,118,258,4,7.1,1,0,0,1,0,0,20,20,1,261,1,870,0.00230000004172325,22,0,0.22432735832951,0.477173107276898,0.997277508243923,117.678745972783,1
"100",2020-06-08,2019,110,258,0,6.4,3,0,0,3,0,0,19,19,0,261,3,701,0.0014300000667572,12,0,0.140593274445554,0.479021590397291,2.99488117677458,109.812309815068,3
"101",2020-06-09,2029,107,259,3,5.7,10,0,3,7,0,0,18,18,1,261,7,1338,0.00224000006914139,10,0,0.222338285794598,0.362482666770557,9.98111153680717,106.711276348338,10
"102",2020-06-10,2039,105,259,7,5.6,10,0,4,6,0,0,17,17,0,261,6,1281,0.00233999997377396,12,0,0.231828303666236,0.338560915156841,9.98311884960649,104.704579868114,10
"103",2020-06-11,2046,104,260,5,5.1,7,0,2,5,0,0,16,16,1,261,5,1529,0.00326999992132187,6,0,0.325721816267175,0.306391212841551,6.98023480135982,103.588883868284,7
"104",2020-06-12,2050,107,260,10,4.4,4,0,2,2,0,0,16,16,0,261,2,1596,0.00814999997615814,13,0,0.808415162333648,0.288706330249938,3.98037775123525,105.950209691086,4
"105",2020-06-13,2053,105,260,6,5,3,0,3,0,0,0,16,16,0,261,0,1479,0.00270000010728836,23,0.0434800004959106,0.332446083228058,0.326524326294968,3,104.57636205675,3
"106",2020-06-14,2056,102,260,1,4.6,3,0,1,2,0,0,16,16,0,261,2,768,0,13,0,0,0.294477560819324,3,102,3
"107",2020-06-15,2061,100,260,2,4.9,5,0,2,3,0,0,14,14,0,261,3,720,0.00555999994277954,17,0,0.543175028331244,0.351989239945851,4.98022368451511,99.3407894838371,5
"108",2020-06-16,2065,99,260,3,4.9,4,0,1,3,1,0,14,14,0,262,3,1250,0.000799999982118607,14,0,0.0791139222822989,0.331528616586951,3.99711956219507,98.9049455524372,4
"109",2020-06-17,2068,89,260,8,5,3,0,0,3,1,1,6,5,0,263,3,1098,0.0091100001335144,26,0,0.889927059305944,0.425542724535481,2.96759888182371,88.0387668274366,3
"110",2020-06-18,2070,75,260,2,4.6,2,0,0,2,0,1,6,5,0,263,2,1304,0.00230000004172325,122,0,0.210322584460527,0.409057119991674,1.99489494721844,74.8085605206913,2
"111",2020-06-19,2073,73,260,5,3.9,3,0,0,3,0,1,5,4,0,263,3,1875,0.0010700000077486,19,0,0.105926611115556,0.308701612674804,2.9961433461216,72.9061547556255,3
"112",2020-06-20,2079,73,261,1,3.1,6,0,0,6,1,1,5,4,1,264,6,1792,0.000560000017285347,158,0,0.0514625656910432,0.268561110169516,5.99625262620082,72.95440695211,6
"113",2020-06-21,2085,77,261,1,3.1,6,0,0,6,0,1,4,3,0,264,6,1102,0.00363000005483627,86,0,0.336722227308887,0.316664285499357,5.97548073953807,76.6853361574052,6
"114",2020-06-22,2087,76,262,6,3.7,2,0,1,1,0,1,1,0,1,264,1,509,0.0039300000667572,10,0,0.385427752211834,0.294128960339441,1.99532235441199,75.6444989353112,2
"115",2020-06-23,2096,81,262,4,3.9,9,0,0,9,0,1,1,0,0,264,9,1255,0.00158999994397163,20,0,0.156505876837992,0.305184953847398,8.98290545716859,80.8461491145173,9
"116",2020-06-24,2098,75,263,3,3.1,2,0,0,2,1,1,2,1,1,265,2,1733,0.00289000004529953,24,0,0.285052366448724,0.218774283439223,1.99308106934896,74.7405401005859,2
"117",2020-06-25,2104,73,263,6,3.7,6,0,0,6,0,1,2,1,0,265,6,1796,0.00277999997138977,21,0.0476200008392334,0.32982388366758,0.235845897611659,5.97598305946464,72.7077938901532,6
"118",2020-06-26,2108,67,263,6,3.9,4,0,0,4,0,1,2,1,0,265,4,2028,0.00196999996900558,23,0,0.194790830674955,0.248540786120145,3.99054388310688,66.8416100420403,4
"119",2020-06-27,2111,69,263,3,4.1,3,0,0,3,0,1,1,0,0,265,3,1574,0.000640000030398369,80,0,0.0609044768952257,0.249889630577885,2.99778254506062,68.9489985363942,3
"120",2020-06-28,2113,68,263,2,4.3,2,0,0,2,0,1,1,0,0,265,2,880,0.00114000000059605,12,0,0.112466367771807,0.217853079215445,1.9972701612378,67.9071854820853,2
"121",2020-06-29,2117,69,263,1,3.6,4,0,0,4,2,1,3,2,0,267,4,854,0.00351000010967255,8,0,0.347742470262222,0.212469467508358,3.98311884888983,68.7088001433495,4
"122",2020-06-30,2120,68,263,10,4.4,3,0,0,3,0,1,3,2,0,267,3,1605,0.00435999989509583,11,0,0.433032167798812,0.251973223359904,2.98423384669983,67.6426338585295,3
"123",2020-07-01,2122,67,263,4,4.6,2,0,0,2,0,2,3,1,0,267,2,1601,0.00312000006437302,15,0,0.309103966773589,0.255409166263456,1.99249727712591,66.7486587837179,2
"124",2020-07-02,2128,66,263,4,4.3,6,0,1,5,0,1,3,2,0,267,5,1012,0.00197999998927116,12,0,0.195679686439689,0.236245709516614,5.98812591702744,65.8432621047623,6
"125",2020-07-03,2136,74,263,4,4,8,0,0,8,0,1,3,2,0,267,8,1334,0.00300000011920929,14,0,0.296884284794154,0.2508304886765,7.97117551692741,73.7333735315786,8
"126",2020-07-04,2139,74,263,4,4.1,3,0,0,3,0,1,3,2,0,267,3,1257,0.00317999988794327,40,0,0.308192741645697,0.286157383640853,2.98877909224277,73.7232176086549,3
"127",2020-07-05,2141,71,263,5,4.6,2,0,0,2,0,1,2,1,0,267,2,734,0.00272000014781952,47,0,0.255631255889824,0.306609510514855,1.99379519295428,70.7797293498769,2
"128",2020-07-06,2147,71,263,0,4.4,6,0,1,5,0,1,2,1,0,267,5,602,0,10,0,0,0.256932014763109,6,71,6
"129",2020-07-07,2154,72,263,6,3.9,7,0,1,6,0,1,1,0,0,267,6,1272,0.0039300000667572,21,0,0.386617175940848,0.250301301640543,6.97184751564603,71.6621701877523,7
"130",2020-07-08,2167,78,263,5,4,13,0,1,12,0,1,1,0,0,267,12,1684,0.00296999990940094,39,0,0.29027741424441,0.247611794136374,12.9577254665785,77.7252155327599,13
"131",2020-07-09,2175,82,263,5,4.1,8,0,0,8,1,0,2,2,0,268,8,1504,0.00266000002622604,41,0,0.258941102876632,0.256649139341652,7.97485941890848,81.742309043812,8
"132",2020-07-10,2191,95,263,12,5.3,16,0,0,16,0,0,2,2,0,268,16,1900,0.00684000015258789,14,0.0714300012588501,0.73124453017455,0.318700602967423,15.8580069969244,94.1569165442386,16
"133",2020-07-11,2198,100,263,7,5.7,7,0,0,7,1,1,2,1,0,269,7,1571,0.00381999999284744,25,0,0.376016290022765,0.328389681307004,6.96805601955319,99.5436574221884,7
"134",2020-07-12,2221,120,263,9,6.3,23,0,2,21,1,1,3,2,0,270,21,1068,0.00842999994754791,13,0,0.832862159480219,0.410851238962775,22.7877357983423,118.787061704813,23
"135",2020-07-13,2244,138,263,6,7.1,23,0,2,21,0,0,3,3,0,270,21,808,0.00619000017642975,65,0,0.572911814725686,0.492695783923587,22.8539870402458,137.040486264472,23
"136",2020-07-14,2263,148,263,4,6.9,19,0,2,17,1,0,4,4,0,271,17,1406,0.00356000006198883,66,0,0.340038049399205,0.486041622989067,18.9298446543333,147.389235814196,19
"137",2020-07-15,2284,168,263,15,8.3,21,0,0,21,1,0,5,5,0,272,21,1404,0.00782999992370606,46,0,0.758159992612641,0.552881991327386,20.8067744779506,166.454195823605,21
"138",2020-07-16,2306,186,263,7,8.6,22,0,1,21,0,0,5,5,0,272,21,1695,0.00708000004291534,25,0.04,0.75584884143846,0.623868811121932,21.8073635005798,184.293791005135,22
"139",2020-07-17,2336,213,263,17,9.3,30,0,0,29,0,1,5,4,0,272,29,1787,0.00726999998092651,21,0,0.718555860946664,0.622056144089377,28.7471034730405,211.142518612332,30
"140",2020-07-18,2362,232,263,16,10.6,26,0,0,24,2,1,6,5,0,274,24,1551,0.00708999991416931,81,0,0.673810653607635,0.664598196030073,23.8037392535697,230.102812784507,26
"141",2020-07-19,2380,250,263,28,13.3,18,0,0,18,0,1,6,5,0,274,18,2025,0.0212299990653992,22,0,2.10018310246377,0.845644045027723,17.5412099440069,243.627915888985,18
"142",2020-07-20,2410,275,263,47,19.1,30,0,0,27,2,3,8,5,0,276,27,1548,0.0148599994182587,35,0.0285700011253357,1.51631264301018,0.980415591925508,26.5031367777599,269.939356069776,30
"143",2020-07-21,2434,294,263,23,21.9,24,0,0,23,0,3,8,5,0,276,23,1428,0.0161099994182587,15,0,1.59425358068423,1.15958923925194,22.5549902069677,288.311613949935,24
"144",2020-07-22,2461,314,263,13,21.6,27,0,1,23,2,3,9,6,0,278,23,1771,0.00902999997138977,16,0,0.894914938406899,1.17912566007969,23.7501991425034,310.589675249829,27
"145",2020-07-23,2480,322,263,29,24.7,19,0,1,17,1,3,10,7,0,279,17,1667,0.0101999998092651,32,0,1.0007886805206,1.21411706566285,17.7935211193414,318.089047083997,19
"146",2020-07-24,2503,337,263,34,27.1,23,0,1,18,0,3,7,4,0,279,18,2036,0.0122800004482269,83,0,1.17989999587494,1.28002337065261,18.7422480046913,332.174309865609,23
"147",2020-07-25,2515,336,263,26,28.6,12,0,1,10,0,3,7,4,0,279,10,2126,0.00800000011920929,320,0,0.695339339878943,1.28309889726279,10.9156119149,333.164560340641,12
"148",2020-07-26,2522,338,263,21,27.6,7,0,0,6,2,4,9,5,0,281,6,1816,0.0121099996566772,73,0,1.16420113163186,1.14938718714395,5.91522581979607,333.224387848512,7
"149",2020-07-27,2537,340,264,22,24,15,0,1,13,1,4,9,5,1,282,13,1601,0.00874000012874603,24,0,0.861091704992148,1.05578419599852,13.8641445425479,336.446857266638,15
"150",2020-07-28,2557,330,264,14,22.7,20,0,2,17,1,4,10,6,0,283,17,1488,0.00739000022411346,24,0,0.727269863325452,0.931929379232978,18.8499524722462,327.087312696543,20
"151",2020-07-29,2573,324,264,20,23.7,16,2,2,12,2,4,11,7,0,285,14,2254,0.00620999991893768,52,0,0.606996522865808,0.890798177012822,15.8968667817209,321.613202662684,16
"152",2020-07-30,2593,334,264,19,22.3,20,1,0,18,1,4,12,8,0,286,19,1891,0.00898999989032745,134,0,0.839510607042431,0.867758452230227,18.8064183800282,330.597038891021,20
"153",2020-07-31,2603,321,264,18,20,10,0,1,9,1,3,13,10,0,287,9,2129,0.00797999978065491,207,0,0.727286795077667,0.803099423544901,9.92056122415106,318.166683661388,10
"154",2020-08-01,2621,309,264,15,18.4,18,0,0,18,1,2,13,11,0,288,18,1629,0.00551999986171722,83,0.0120500004291534,0.583658283315251,0.787144986892945,17.8724984425554,306.811223263867,18
"155",2020-08-02,2629,294,264,2,15.7,8,0,0,8,0,2,13,11,0,288,8,1340,0.00149000003933907,11,0,0.147786828476266,0.641942943585003,7.98565138286549,293.472688320307,8
"156",2020-08-03,2638,280,264,10,14,9,0,1,7,0,1,12,11,0,288,7,1046,0.0114699995517731,47,0,1.09767790769942,0.675740972543185,7.90674818471741,276.269927388696,9
"157",2020-08-04,2650,268,264,20,14.9,12,0,1,11,1,1,11,10,0,289,11,1699,0.0058899998664856,12,0,0.584869069150148,0.655398001946712,11.9219207432342,266.097705380615,12
"158",2020-08-05,2659,248,264,12,13.7,9,1,0,8,1,1,12,11,0,290,9,1599,0.005,70,0,0.479029358897543,0.637116978522675,8.94767744152091,246.558222833021,9
"159",2020-08-06,2669,224,264,13,12.9,10,0,0,10,1,2,10,8,0,291,10,1639,0.00305000007152557,10,0,0.303150401287472,0.560494091986252,9.96320892491658,223.175879918131,10
"160",2020-08-07,2681,225,264,6,11.1,12,0,3,9,1,2,10,8,0,292,9,1689,0,39,0,0,0.456595978403728,12,225,12
"161",2020-08-08,2687,208,264,14,11,6,1,1,4,0,1,10,9,0,292,5,1518,0.00725000023841858,95,0,0.682300084433937,0.470687664277826,5.95859719543629,206.27764333015,6
"162",2020-08-09,2689,199,264,16,13,2,0,1,1,2,2,12,10,0,294,1,1589,0.00441000014543533,102,0,0.414399185753799,0.508775143888902,1.99497074999973,197.999179249946,2
"163",2020-08-10,2701,200,264,8,12.7,12,2,0,10,0,1,12,11,0,294,12,1384,0.00578000009059906,27,0,0.566939767922686,0.432955409635084,11.9174337616675,198.623896027791,12
"164",2020-08-11,2714,204,264,8,11,13,2,1,10,0,1,12,11,0,294,12,1460,0.00342000007629395,41,0,0.332658235269098,0.396925290509219,12.9515533383076,203.17640675123,13
"165",2020-08-12,2721,187,264,12,11,7,3,0,4,0,2,10,8,0,294,7,1486,0.00268999993801117,7,0,0.267738774808078,0.366740921353581,6.97725459663781,186.392372795896,7
"166",2020-08-13,2743,190,264,11,10.7,22,0,0,22,0,2,9,7,0,294,22,1689,0.00532999992370605,56,0,0.515895121555274,0.397133024248982,21.8622573502864,188.810404388837,22
"167",2020-08-14,2754,185,264,6,10.7,11,4,1,6,1,2,10,8,0,295,10,1882,0.00477999985218048,36,0,0.469028139822923,0.464137044223685,10.9430775963509,183.946935532492,11
"168",2020-08-15,2758,177,264,2,9,4,0,0,4,1,2,11,9,0,296,4,2044,0.00734000027179718,21,0,0.726535620123653,0.470456406465073,3.96473034317326,175.439317685417,4
"169",2020-08-16,2762,158,264,26,10.4,4,0,1,3,0,2,11,9,0,296,3,1196,0.00501999974250793,22,0,0.492932651234769,0.481675472962354,3.98205294589192,157.054788483641,4
"170",2020-08-17,2785,172,265,8,10.4,23,1,4,18,1,1,9,8,1,297,19,1358,0.00662999987602234,32,0,0.647736678535132,0.493217888764132,22.8506392718637,170.647892355819,23
"171",2020-08-18,2811,191,265,15,11.4,26,1,1,24,0,1,7,6,0,297,25,1888,0.00583000004291534,77,0.0519500017166138,0.76372469278389,0.554798811266246,25.7682812525075,189.229668769157,26
"172",2020-08-19,2835,200,265,23,13,24,4,3,15,2,1,7,6,0,299,19,1519,0.0118499994277954,25,0.04,1.23057960691847,0.692347501567731,21.7162423061564,197.01307690691,24
"173",2020-08-20,2852,208,266,24,14.9,17,1,0,16,3,0,6,6,1,302,17,1607,0.00995999991893768,103,0,0.936007009925898,0.752363485620677,16.806886625059,205.637201059546,17
"174",2020-08-21,2873,215,266,16,16.3,21,3,2,16,0,0,6,6,0,302,19,1804,0.00721000015735626,116,0.00861999988555908,0.729518764093518,0.789576431945048,20.8317812509236,213.096472049925,21
"175",2020-08-22,2892,225,266,16,18.3,19,1,0,18,1,0,7,7,0,303,19,1864,0.00589999973773956,73,0,0.567764559171221,0.766894851808986,18.8690799351373,223.449630810836,19
"176",2020-08-23,2909,235,266,13,16.4,17,0,1,15,0,0,7,7,0,303,15,694,0.0172899997234344,5,0,1.71663230444399,0.941709087981732,15.6874979495235,230.104134542534,17
"177",2020-08-24,2928,251,266,19,18,19,2,0,17,1,1,8,7,0,304,19,1142,0.00962999999523163,58,0,0.91645499954621,0.980097419554743,18.7886758762126,248.208297101546,19
"178",2020-08-25,2942,253,266,23,19.1,14,0,1,13,4,2,11,9,0,308,13,1647,0.0145700001716614,73,0,1.3951622257399,1.0703027814056,13.7798836043839,248.716196300703,14
"179",2020-08-26,2960,261,266,15,18,18,1,4,13,0,2,11,9,0,308,14,1832,0.0049099999666214,41,0,0.480251998870817,0.96311312311308,17.9184016178632,259.478773018735,18
"180",2020-08-27,2973,264,266,16,16.9,13,1,3,9,1,2,9,7,0,309,10,1469,0.00612999975681305,9,0,0.609267228874044,0.916436011534243,12.926057837073,262.047926898728,13
"181",2020-08-28,3001,274,266,20,17.4,28,0,3,21,1,1,9,8,0,310,21,2137,0.00607999980449677,35,0,0.598202559033591,0.897676553668539,23.8475414122523,272.01077842653,28
"182",2020-08-29,3022,288,266,12,16.9,21,0,2,18,0,1,9,8,0,310,18,1790,0.00726000010967255,11,0.0909099960327148,0.777091068999096,0.927580340786807,19.8302425847348,285.283881355758,21
"183",2020-08-30,3042,302,267,16,17.3,20,0,6,12,2,1,10,9,1,312,12,1402,0.00428000003099442,33,0,0.418157494317364,0.742083939340146,17.9391016589596,300.467391750483,20
"184",2020-08-31,3062,311,267,13,16.4,20,1,3,16,1,1,11,10,0,313,17,1353,0.00517000019550324,54,0,0.497157801315983,0.682184339592971,19.8974283099675,309.123541435288,20
"185",2020-09-01,3087,315,267,18,15.7,25,1,2,22,0,1,11,10,0,313,23,1361,0.0154299998283386,22,0.0909099960327148,1.6630693911127,0.720456791789084,24.5357813998324,308.642223519444,25
"186",2020-09-02,3123,325,267,15,15.7,36,1,9,26,0,1,9,8,0,313,27,1528,0.00261999994516373,51,0,0.253537676770752,0.688069031489075,35.9169211259826,323.999976516458,36
"187",2020-09-03,3145,326,267,24,16.9,22,1,4,17,1,1,8,7,0,314,18,1493,0.00938000023365021,133,0.00751999974250793,0.922785997207461,0.732857426965278,21.798415176833,322.349074869309,22
"188",2020-09-04,3167,330,267,24,17.4,22,0,3,19,3,1,11,10,0,317,19,2705,0.00813000023365021,258,0.00774999976158142,0.809691210614641,0.763070091476856,21.8132943944807,326.757218430454,22
"189",2020-09-05,3192,337,267,17,18.1,25,1,11,13,2,1,13,12,0,319,14,2256,0.00398999989032745,164,0,0.371960320354493,0.705194270241913,24.9368011784826,335.478714082045,25
"190",2020-09-06,3213,339,267,26,19.6,21,1,3,16,1,1,14,13,0,320,17,1310,0.00611000001430511,192,0.03125,0.932363516560566,0.778652273419513,19.8076383366305,335.164082124573,21
"191",2020-09-07,3254,364,267,29,21.9,41,2,6,33,0,1,12,11,0,320,35,1290,0.0147300004959106,44,0,1.4244153403092,0.91111763613283,40.3949531312031,357.707512564513,41
"192",2020-09-08,3306,401,267,24,22.7,52,0,14,36,3,1,14,13,0,323,36,1097,0.0127600002288818,4,0,1.27136423715562,0.855159756996105,49.4445348418736,394.812735321981,52
"193",2020-09-09,3351,432,267,15,22.7,45,2,10,31,0,1,13,12,0,323,33,1587,0.0144900000095367,29,0,1.42299690687715,1.02222536129702,42.4300953150227,424.539429578479,45
"194",2020-09-10,3428,494,267,33,24,77,1,21,52,2,2,14,12,0,325,53,1959,0.0127600002288818,61,0,1.23746734892968,1.06717984011448,73.2040350401706,486.581005846118,77
"195",2020-09-11,3458,508,267,60,29.1,30,0,1,25,0,1,12,11,0,325,25,2314,0.0155599999427795,93,0.0752699995040894,1.78670335776785,1.20675300399351,25.4579032626359,496.984594296761,30
"196",2020-09-12,3507,533,269,47,33.4,49,0,4,42,1,0,12,12,2,326,42,1900,0.0168400001525879,26,0,1.66126688940379,1.39093965671484,45.1532152445496,522.253898222498,49
"197",2020-09-13,3542,546,270,31,34.1,35,1,5,29,1,1,11,10,1,327,30,1199,0.0166799998283386,44,0,1.6089557356539,1.48759568801389,34.4141995752775,535.33843227005,35
"198",2020-09-14,3610,596,272,59,38.4,68,0,19,49,1,1,11,10,2,328,49,2394,0.0141999995708466,218,0.0412799978256226,1.6460121936674,1.51925238135077,67.0211560534098,584.094061384332,68
"199",2020-09-15,3683,645,273,41,40.9,73,0,15,55,1,1,11,10,1,329,55,2961,0.0121599996089935,28,0,1.20460886056306,1.5097158989804,69.1959314529753,635.570468857619,73
"200",2020-09-16,3760,685,274,41,44.6,77,0,7,67,1,0,11,11,1,330,67,1887,0.0190799999237061,162,0.00616999983787537,1.80592971350752,1.56442058564189,72.5315472478378,669.986714399535,77
"201",2020-09-17,3810,710,278,57,48,50,2,4,38,2,2,11,9,4,332,40,2512,0.0191100001335144,208,0.00481000006198883,1.80164707162801,1.6450176888845,43.1253907973788,694.475686653474,50
"202",2020-09-18,3898,778,278,47,46.1,88,1,6,78,0,2,11,9,0,332,79,2409,0.0128699994087219,281,0.0213499999046326,1.37558284568078,1.58628618715778,83.6811415878148,765.011748801518,88
"203",2020-09-19,3968,829,280,47,46.1,70,2,4,60,0,2,10,8,2,332,62,2101,0.0214199995994568,161,0,1.98954107685494,1.6331824996508,64.5029754209749,808.98333264497,70
"204",2020-09-20,4011,861,280,76,52.6,43,1,4,34,2,2,11,9,0,334,35,2847,0.0186199998855591,112,0,1.79152212484578,1.6592634123925,38.2390177068839,842.279835589344,43
"205",2020-09-21,4120,941,280,55,52,109,2,22,82,1,3,12,9,0,335,84,2949,0.0189900004863739,73,0,1.85312744653596,1.68885130565944,104.110839285798,919.836901999232,109
"206",2020-09-22,4229,1020,280,85,58.3,109,0,27,81,3,3,15,12,0,338,81,2507,0.0135599994659424,64,0.03125,1.4000357316654,1.71676943010263,106.623714704036,1002.66899997674,109
"207",2020-09-23,4335,1079,281,67,62,106,0,26,75,2,3,16,13,1,340,75,1896,0.0168799996376038,7,0.571430015563965,1.89198578149472,1.7290631541008,99.2778797921403,1054.22443060959,106
"208",2020-09-24,4436,1132,282,38,59.3,101,2,18,75,2,3,18,15,1,342,77,2730,0.0128199994564056,55,0,1.25668217292594,1.65121102571479,93.8256419998955,1114.7354122582,101
"209",2020-09-25,4555,1195,284,57,60.7,119,5,16,86,3,3,20,17,2,345,91,3291,0.0133700001239777,59,0.0339000010490417,1.37315732745982,1.65086452311179,105.483487402608,1175.08535655073,119
"210",2020-09-26,4640,1242,286,76,64.9,85,3,14,66,3,4,21,17,2,348,69,3437,0.0299699997901916,12,0,2.98657260883992,1.79329759910965,80.4990414173031,1196.98274551146,85
"211",2020-09-27,4722,1272,287,109,69.6,82,2,12,64,2,4,22,18,1,350,66,2684,0.0331599998474121,13,0,3.30001629923819,2.00879676687999,75.3567128075289,1221.05664683601,82
"212",2020-09-28,4837,1342,288,86,74,115,3,11,97,6,4,27,23,1,356,100,3135,0.0258400011062622,192,0.0104200005531311,2.49501182970644,2.10049453590435,107.971992543276,1301.36413993076,115
"213",2020-09-29,4944,1373,291,58,70.1,107,5,18,74,4,3,27,24,3,360,79,2165,0.0263299989700317,79,0.0253200006484985,2.62944419881239,2.27612431692535,94.478985281138,1329.18540241775,107
"214",2020-09-30,5027,1402,291,107,75.9,83,1,10,67,5,5,30,25,0,365,68,3170,0.0305999994277954,281,0.0142299997806549,2.92670611777675,2.42394150782278,75.5846928928063,1352.20205052521,83
"215",2020-10-01,5128,1438,293,105,85.4,101,2,11,78,3,5,29,24,2,368,80,3844,0.0226300001144409,120,0.00833000004291534,2.21971040476944,2.56151696951471,88.8448840755353,1399.26179125775,101
"216",2020-10-02,5224,1488,294,115,93.7,96,0,13,79,1,5,29,24,1,369,79,3362,0.021710000038147,197,0,2.05082945007727,2.65832727274577,90.0337398938317,1450.96461977242,96
"217",2020-10-03,5297,1501,295,65,92.1,73,2,6,64,5,6,31,25,1,374,66,3113,0.0301999998092651,485,0.0103100001811981,2.75188853513406,2.62480097650208,69.7957588507344,1450.87021265079,73
"218",2020-10-04,5354,1482,295,77,87.6,57,1,7,47,3,6,32,26,0,377,48,3118,0.0291899991035461,102,0,2.82653469580301,2.55716074743991,53.3534311716821,1431.16218742569,57
"219",2020-10-05,5432,1483,295,82,87,78,3,13,59,3,6,33,27,0,380,62,3821,0.0177999997138977,238,0.00839999973773956,1.72488294763206,2.447142335715,73.7021166848043,1451.95546844459,78
"220",2020-10-06,5508,1456,296,139,98.6,76,5,15,53,2,7,34,27,1,382,58,2158,0.0194599997997284,55,0,1.89763576899295,2.34259827431222,71.6642500006049,1422.4680689807,76
"221",2020-10-07,5609,1470,296,174,108.1,101,12,22,63,3,10,36,26,0,385,75,2268,0.0313100004196167,76,0,3.02948297575472,2.35728068259479,94.2425089538503,1415.95317549547,101
"222",2020-10-08,5689,1429,296,85,105.3,80,5,14,55,2,9,36,27,0,387,60,2434,0.0271199989318848,182,0,2.52332100153698,2.40065362499015,72.1625815034484,1385.23881614046,80
"223",2020-10-09,5772,1430,296,97,102.7,83,5,19,57,2,9,37,28,0,389,62,2508,0.0207299995422363,247,0.00810000002384186,1.95976547578285,2.38764448580523,79.5253799881279,1395.98860295198,83
"224",2020-10-10,5837,1415,297,68,103.1,65,5,7,51,6,9,43,34,1,395,56,2628,0.0300600004196167,21,0,2.98216991705371,2.42054182607947,60.9732287127524,1363.78783265258,65
"225",2020-10-11,5901,1380,297,139,112,64,6,6,48,5,10,46,36,0,400,54,2660,0.0233100008964539,238,0.0168099999427795,2.2776184393012,2.34212521800778,58.5073463022268,1341.85440550135,64
"226",2020-10-12,5963,1352,297,62,109.1,62,2,14,43,3,10,46,36,0,403,45,1994,0.0150499999523163,237,0.0126600003242493,1.47961093598233,2.30708635920068,58.1919385702955,1327.72224326754,62
"227",2020-10-13,6048,1374,298,74,99.9,85,4,10,68,1,7,45,38,1,404,72,2117,0.0302300000190735,18,0,2.9975133508374,2.4642117280356,79.3807439618816,1324.01586393924,85
"228",2020-10-14,6115,1379,300,84,87,67,1,16,49,2,7,45,38,2,406,50,3004,0.0296300005912781,110,0.0363599991798401,2.98677333609447,2.45811035094128,64.1875893682029,1329.01371477504,67
"229",2020-10-15,6201,1405,300,107,90.1,86,3,25,52,5,8,49,41,0,411,55,2119,0.021710000038147,105,0.00952000021934509,2.11344829603708,2.39955710729843,78.5892870655027,1368.96269685511,86
"230",2020-10-16,6276,1426,301,78,87.4,75,2,10,59,4,8,47,39,1,415,61,3126,0.0214299988746643,280,0.0035699999332428,1.99617664308598,2.40475870262745,69.5222085964387,1391.45359768068,75
"231",2020-10-17,6323,1408,302,64,86.9,47,1,10,36,6,8,49,41,1,421,37,3037,0.0214000010490417,149,0,2.03991849296735,2.2701513563294,46.0839928357533,1373.14221385785,47
"232",2020-10-18,6380,1376,305,74,77.6,57,1,11,40,2,6,48,42,3,423,41,1144,0.0271000003814697,37,0.0540500020980835,2.79443272769098,2.34398196895651,50.6095292836825,1329.33444620359,57
"233",2020-10-19,6444,1355,307,69,78.6,64,1,6,57,3,6,47,41,2,426,58,1334,0.0374799990653992,27,0,3.67364575703472,2.65741551482114,61.414112656434,1294.58832154255,64
"234",2020-10-20,6522,1358,309,46,74.6,78,3,14,57,4,5,45,40,2,430,60,1595,0.0250799989700317,48,0.0208299994468689,2.49558358677117,2.58571126281168,72.1827791869402,1316.87023559775,78
"235",2020-10-21,6610,1382,312,69,72.4,88,1,46,40,4,4,44,40,3,434,41,2258,0.0305599999427795,446,0.00897000014781952,2.69989274913919,2.54472832181807,85.6565710572757,1336.71661466232,88
"236",2020-10-22,6675,1368,312,88,69.7,65,1,24,36,1,3,43,40,0,435,37,2238,0.0268099999427795,87,0.0114900004863739,2.62367354469915,2.61761764305551,59.8218628480136,1324.44076692115,65
"237",2020-10-23,6754,1370,313,92,71.7,79,1,13,64,2,3,36,33,1,437,65,2768,0.0245700001716614,65,0.0153799998760223,2.4359145946735,2.68043735042515,76.0784143567112,1329.49888721068,79
"238",2020-10-24,6819,1363,317,63,71.6,65,2,17,41,2,3,36,33,4,439,43,2358,0.0211999988555908,191,0,1.96114544140773,2.6691840573452,58.9765595223527,1330.55931695272,65
"239",2020-10-25,6889,1344,319,69,70.9,70,1,24,42,3,3,38,35,2,442,43,1751,0.0308400011062622,77,0,2.95409419787008,2.69199283879936,65.4583807436979,1295.81543533791,70
"240",2020-10-26,6962,1303,320,77,72,73,1,16,51,4,3,39,36,1,446,52,995,0.0392000007629395,121,0.0165299999713898,3.67420526484435,2.69207276848645,65.6812651468621,1244.89785550695,73
"241",2020-10-27,7040,1273,322,61,74.1,78,0,15,60,1,3,31,28,2,447,60,1354,0.0288000011444092,116,0,2.65273479928776,2.71452294170311,73.0683456509543,1232.01673356108,78
"242",2020-10-28,7152,1279,325,94,77.7,112,2,69,38,2,2,29,27,3,449,40,1900,0.0405299997329712,166,0.01807000041008,3.87253724882471,2.88204358451532,107.120077584199,1218.88948075477,112
"243",2020-10-29,7216,1263,326,65,74.4,64,0,18,42,9,2,37,35,1,458,42,2190,0.0292199993133545,96,0,2.79929127280168,2.90713183138712,58.573138855055,1220.09224699844,64
"244",2020-10-30,7266,1232,328,122,78.7,50,1,9,36,4,2,40,38,2,462,37,2789,0.0358599996566772,105,0.0571400022506714,3.66320799166528,3.0824594595288,44.3550691970981,1177.22825002229,50
"245",2020-10-31,7305,1162,329,83,81.6,39,0,5,32,2,2,39,37,1,464,32,2352,0.0276399993896484,322,0,2.43116224997955,3.1496047178962,36.0558342261891,1127.71498033849,39
"246",2020-11-01,7355,1122,332,50,78.9,50,1,6,40,1,2,37,35,3,465,41,1714,0.0256699991226196,104,0,2.42015283257261,3.07332737999656,45.7957657347201,1089.04510132575,50
"247",2020-11-02,7419,1075,332,56,75.9,64,3,8,47,6,2,42,40,0,471,50,1030,0.0174800002574921,14,0.0714300012588501,1.82034677038704,2.80849045221695,56.8953912905487,1051.2509127468,64
"248",2020-11-03,7490,1003,333,36,72.3,71,1,36,33,1,2,43,41,1,472,34,1456,0.0219799995422363,13,0,2.17854862719511,2.74074957048943,69.1010604121352,976.481282157987,71
"249",2020-11-04,7555,927,337,53,66.4,65,5,1,51,1,1,40,39,4,473,56,1466,0.0272900009155273,295,0.0033899998664856,2.32863096551825,2.52019153001707,55.4173932033455,900.802205348236,65
"250",2020-11-05,7602,884,337,45,63.6,47,0,6,34,5,2,43,41,0,478,34,2536,0.0240499997138977,41,0,2.36673648717286,2.45839798921296,39.0234080177026,858.608608460266,47
"251",2020-11-06,7676,878,341,79,57.4,74,1,12,58,4,3,46,43,4,482,59,2342,0.0234800004959106,116,0.0258599996566772,2.35923194148077,2.27211569632945,69.3106992210318,852.860913831626,74
"252",2020-11-07,7711,845,346,75,56.3,35,3,4,25,3,4,46,42,5,485,28,2499,0.0276099991798401,142,0,2.61254782091709,2.2980279207491,31.112217436083,818.207990481792,35
"253",2020-11-08,7748,783,346,47,55.9,37,1,5,29,1,4,47,43,0,486,30,1176,0.0204099988937378,92,0.0108700001239777,1.97178223268467,2.23397497790797,34.2820990386677,764.262784909228,37
"254",2020-11-09,7818,751,350,31,52.3,70,3,24,41,7,4,46,42,4,493,44,711,0.0210999989509583,20,0.1,2.3258685710166,2.30619237799791,66.7579983354307,729.801289770647,70
"255",2020-11-10,7885,760,350,51,54.4,67,0,11,54,3,5,47,42,0,496,54,1374,0.0334800004959106,17,0,3.30708272332,2.46741153458718,62.8326794468172,729.496969992242,67
"256",2020-11-11,7941,759,353,78,58,56,0,6,48,2,5,46,41,3,498,48,2375,0.0261100006103516,241,0.0290499997138977,2.63808491516186,2.51161924167912,52.4632106606684,734.699518571818,56
"257",2020-11-12,7983,749,355,58,59.9,42,1,8,31,3,3,43,40,2,501,32,2318,0.0215700006484985,214,0.00467000007629395,2.01416435701211,2.4612517945133,39.2177794597063,730.69115047875,42
"258",2020-11-13,8021,725,357,81,60.1,38,1,7,26,0,3,36,33,2,501,27,2719,0.0217000007629395,200,0,2.02131901591067,2.41297851943186,33.3376569904298,707.214863631913,38
"259",2020-11-14,8042,702,357,50,56.6,21,3,2,14,3,3,37,34,0,504,17,1710,0.015789999961853,245,0.0163300001621246,1.58576726212221,2.26629558246116,18.6728305828782,688.489827598854,21
"260",2020-11-15,8072,658,360,29,54,30,1,1,25,0,2,35,33,3,504,26,984,0.0152400004863739,306,0.00653999984264374,1.31762794034426,2.17284496926967,26.5842325607149,647.477885575015,30
"261",2020-11-16,8116,619,363,11,51.1,44,0,3,39,3,2,33,31,3,507,39,735,0.0122399997711182,53,0,1.1416751055548,2.0036744742037,41.4596297020598,610.423353476283,44
"262",2020-11-17,8157,597,363,39,49.4,41,1,10,29,1,2,32,30,0,508,30,1828,0.020789999961853,38,0,2.03666237568421,1.82218585311287,39.2584769995507,582.243692291059,41
"263",2020-11-18,8198,589,363,66,47.7,41,3,6,30,1,2,32,30,0,509,33,2684,0.0204900002479553,20,0.05,2.07082694768906,1.74114900061676,38.1706419222968,574.197214916147,41
"264",2020-11-19,8218,573,364,53,47,20,2,1,17,0,2,30,28,1,509,19,2476,0.0121200001239777,187,0.0160399997234344,1.23952685900304,1.63048650090118,19.7141791713511,564.380245536009,20
"265",2020-11-20,8243,530,364,28,39.4,25,1,2,20,1,2,30,28,0,510,21,2643,0.00757000029087067,222,0.0225200009346008,0.872842966012306,1.46641849377284,22.7775462443044,524.385690927681,25
"266",2020-11-21,8272,498,365,27,36.1,29,4,4,19,2,2,31,29,1,512,23,1495,0.0187300002574921,71,0,1.7880811229215,1.49532047388702,26.500886421033,487.193105985845,29
"267",2020-11-22,8299,484,368,26,35.7,27,3,4,19,3,4,31,27,3,515,22,1220,0.0147500002384186,36,0,1.4327229530948,1.51176261856567,25.617466714417,475.584267717174,27
"268",2020-11-23,8339,467,370,20,37,40,2,10,25,1,3,27,24,2,516,27,922,0.0173500001430511,13,0,1.71087701945381,1.5930771776941,36.4393821929395,457.303388300102,40
"269",2020-11-24,8383,477,370,21,34.4,44,2,7,34,1,3,23,20,0,517,36,1403,0.00855000019073486,41,0.0975599956512451,1.10772923056108,1.46037244267651,42.5160277643239,470.587367877292,44
"270",2020-11-25,8438,485,371,38,30.4,55,4,10,39,2,2,23,21,1,519,43,2618,0.0122200000286102,72,0.0138900005817413,1.22646989281736,1.33975000626627,52.3599562243461,477.780901600183,55
"271",2020-11-26,8483,500,372,60,31.4,45,3,4,37,3,2,23,21,1,522,40,3059,0.0143799996376038,224,0.00446000009775162,1.37031553193196,1.35843410239897,43.3347806051496,491.68475756437,45
"272",2020-11-27,8529,511,374,56,35.4,46,2,3,40,3,1,24,23,2,525,42,3154,0.0177600002288818,336,0.00298000007867813,1.63370546556817,1.46712874519267,44.1672639164947,500.868377650685,46
"273",2020-11-28,8574,514,375,60,40.1,45,2,3,40,2,1,25,24,1,527,42,2597,0.0119400000572205,191,0,1.11220158352229,1.3705745252785,44.4330860670723,507.062053297027,45
"274",2020-11-29,8619,526,377,23,39.7,45,0,4,38,5,1,28,27,2,532,38,898,0.0245000004768372,12,0,2.41769235474723,1.51128443980027,40.8850151535921,510.566262389196,45
"275",2020-11-30,8663,533,378,45,43.3,44,1,7,35,1,1,25,24,1,533,36,1135,0.0229099988937378,61,0,2.17415123280873,1.57746647027955,42.0501028556343,518.936245057031,44
"276",2020-12-01,8716,554,378,34,45.1,53,2,11,39,3,1,27,26,0,536,41,1906,0.0141700005531311,113,0.0176999998092651,1.43675686145195,1.62447041754967,51.2850898421992,544.339994453131,53
"277",2020-12-02,8758,568,379,50,46.9,42,1,5,34,6,1,31,30,1,542,35,2859,0.0101400005817413,81,0.0123500001430511,1.0200888324757,1.59498740892943,39.566698324205,560.968132804241,42
"278",2020-12-03,8796,567,380,40,44,38,0,6,31,3,1,33,32,1,545,31,3327,0.0102199995517731,202,0,0.963500666158941,1.53687099953329,36.6375083188966,560.369910219818,38
"279",2020-12-04,8838,570,382,54,43.7,42,1,5,32,2,1,31,30,2,547,33,2994,0.0110199999809265,165,0.0121200001239777,1.10774548791865,1.46173385986907,37.5563522729556,562.336993805597,42
"280",2020-12-05,8873,559,382,45,41.6,35,3,2,29,1,1,31,30,0,548,32,2277,0.0184500002861023,209,0,1.68988940673592,1.54426069175673,33.3437148263638,547.535518373042,35
"281",2020-12-06,8912,553,383,33,43,39,0,7,30,1,2,31,29,1,549,30,1397,0.0157500004768372,20,0,1.55276998349623,1.42070035300659,36.4346560967019,542.578827382538,39
"282",2020-12-07,8965,555,384,24,40,53,0,4,44,2,1,30,29,1,551,44,1068,0.0168499994277954,25,0.04,1.73795053878184,1.3583859681456,47.0719434928507,543.293832693912,53
"283",2020-12-08,9012,560,384,57,43.3,47,1,1,44,0,1,27,26,0,551,45,2367,0.01942999958992,69,0,1.88796424586785,1.4228441659193,44.9689241606381,547.168833999052,47
"284",2020-12-09,9067,571,386,39,41.7,55,2,3,48,1,3,24,21,2,552,50,2911,0.00962000012397766,167,0.00598999977111816,0.942305078709412,1.41173220109555,52.4281977402133,564.470018193236,55
"285",2020-12-10,9111,569,386,57,44.1,44,2,0,42,1,3,23,20,0,553,44,3091,0.0139100003242493,252,0.00397000014781952,1.3160709255012,1.46209938100158,43.2972250020777,559.911841504141,44
"286",2020-12-11,9150,553,386,49,43.4,39,6,2,30,1,2,23,21,0,554,36,3047,0.0118099999427795,32,0,1.16872587936503,1.47081086549392,37.4893780347005,545.156279255261,39
"287",2020-12-12,9179,538,387,56,45,29,2,5,22,0,2,20,18,1,554,24,2616,0.0156700003147125,24,0,1.5527545766397,1.45122017548018,28.5477293649147,527.861599930172,29
"288",2020-12-13,9219,536,388,28,44.3,40,5,2,33,0,2,19,17,1,554,38,1502,0.0119799995422363,47,0,1.16165005244926,1.39534589961632,39.4642733585327,528.443434741409,40
"289",2020-12-14,9261,533,388,19,43.6,42,3,4,35,2,2,20,18,0,556,38,917,0.0174500000476837,20,0,1.70775347318313,1.39103203310222,41.2124228542723,521.95319424545,42
"290",2020-12-15,9309,543,389,51,42.7,48,2,7,38,1,1,20,19,1,557,40,2079,0.0134700000286102,49,0,1.31598355542672,1.30932050589635,46.3611560520373,534.327693406406,48
"291",2020-12-16,9363,559,389,54,44.9,54,3,4,46,0,1,18,17,0,557,49,2312,0.0168700003623962,94,0,1.62109064164007,1.4062898720293,52.0359763022728,548.002260264703,54
"292",2020-12-17,9401,555,390,60,45.3,38,1,5,30,1,0,17,17,1,558,31,3207,0.0134099996089935,83,0.0241000008583069,1.36796865706023,1.41370383368059,35.4853379186841,545.785888544184,38
"293",2020-12-18,9442,544,390,23,41.6,41,3,4,34,0,0,16,16,0,558,37,3298,0.00727999985218048,170,0.00587999999523163,0.72113724082124,1.34976259960291,40.6761797683218,539.238967404515,41
"294",2020-12-19,9481,541,390,46,40.1,39,1,7,28,3,0,19,19,0,561,29,2799,0.0117900002002716,140,0,1.12283805922287,1.28834595425765,35.6048159079222,533.6277726271,39
"295",2020-12-20,9525,536,390,24,39.6,44,5,2,34,0,0,16,16,0,561,39,1360,0.0161800003051758,51,0,1.55951810170369,1.34518424700828,40.2618589499232,525.855292234842,44
"296",2020-12-21,9599,556,390,28,40.9,74,7,8,59,1,0,15,15,0,562,66,1365,0.00658999979496002,32,0.03125,0.715486737302823,1.20343185616824,73.4269007309048,551.172072823986,74
"297",2020-12-22,9681,598,390,67,43.1,82,5,7,68,2,0,15,15,0,564,73,3021,0.0225099992752075,48,0,2.21579367254487,1.33197615861369,78.0369267316914,581.91893404865,82
"298",2020-12-23,9781,665,390,52,42.9,100,5,6,88,1,1,13,12,0,565,93,2652,0.0199800002574921,199,0.0150800001621246,1.96379799070964,1.38093435133791,96.7835186004454,649.150966336518,100
"299",2020-12-24,9854,693,390,55,42.1,73,11,5,55,2,1,13,12,0,567,66,3469,0.01557000041008,144,0,1.49494413015686,1.39907370463743,69.8025614680704,680.426895414739,73
"300",2020-12-25,9917,722,390,52,46.3,63,6,2,54,0,1,10,9,0,567,60,2537,0.0295600008964539,161,0,2.77960423551903,1.69314041816568,59.9759625381294,697.644082542157,63
"301",2020-12-26,10010,765,390,86,52,93,5,4,83,2,2,12,10,0,569,88,951,0.0199800002574921,50,0,1.89819982466283,1.80390638465711,89.9727424229428,747.376681290355,93
"302",2020-12-27,10121,830,391,35,53.6,111,8,6,95,2,4,12,8,1,571,103,1480,0.0270300006866455,32,0.0625,2.77806885028012,1.97798506302517,105.527321639682,802.016281174135,111
"303",2020-12-28,10255,926,391,65,58.9,134,15,7,110,1,2,13,11,0,572,125,1188,0.04125,39,0.0256399989128113,4.07538385962507,2.45797036621406,125.817517932665,880.200172845186,134
"304",2020-12-29,10375,1003,391,112,65.3,120,5,15,100,3,4,12,8,0,575,105,1880,0.0505299997329712,25,0.04,5.03918107600976,2.8613114238519,113.578542764055,941.659794212826,120
"305",2020-12-30,10512,1094,391,88,70.4,137,12,10,115,3,5,13,8,0,578,127,2458,0.0573600006103516,62,0,5.59487625000969,3.38003688946619,128.376599886415,1019.71653760423,137
"306",2020-12-31,10638,1182,391,147,83.6,126,0,9,117,2,5,13,8,0,580,117,2652,0.0331800007820129,144,0,3.14711595400209,3.6160614357298,121.53128212017,1136.85449116275,126
"307",2021-01-01,10755,1237,392,88,88.7,117,0,5,111,2,6,13,7,1,582,111,2759,0.0391400003433228,134,0.0149300003051758,3.80186246070242,3.76209832504171,110.878422941666,1179.92440701659,117
"308",2021-01-02,10867,1296,392,133,95.4,112,2,8,100,2,6,15,9,0,584,102,2369,0.0295499992370605,431,0,2.50014100687844,3.84808992250108,106.905083001217,1256.67634872134,112
"309",2021-01-03,10990,1323,393,107,105.7,123,0,5,118,3,5,18,13,1,587,118,1516,0.0600299978256226,126,0.0238100004196167,5.72506313986087,4.26908910672691,114.801269343837,1231.07694357539,123
"310",2021-01-04,11166,1435,393,115,112.9,176,4,30,141,5,8,21,13,0,592,145,1386,0.0533900022506714,155,0.00644999980926514,4.86685873393035,4.38215694591337,166.435518531629,1350.24116615784,176
"311",2021-01-05,11309,1510,395,106,112,143,2,19,122,6,8,23,15,2,598,124,2417,0.0575099992752075,97,0.0103100001811981,5.56888378145397,4.45782876097683,134.619418170798,1407.94614062826,143
"312",2021-01-06,11493,1605,395,132,118.3,184,11,42,130,7,7,28,21,0,605,141,2627,0.0513899993896484,211,0.0142200005054474,4.86264793880394,4.35322471651887,174.678985646334,1510.28207065508,184
"313",2021-01-07,11610,1640,395,188,124.1,117,2,7,107,6,9,32,23,0,611,109,2311,0.048899998664856,91,0.0109899997711182,4.74637747267502,4.58169064775786,109.721251271301,1545.53075307278,117
"314",2021-01-08,11742,1671,395,186,138.1,132,6,13,112,0,11,30,19,0,611,118,2661,0.0368300008773804,249,0,3.36785678126148,4.51968983640915,126.176970111326,1602.70099200022,132
"315",2021-01-09,11841,1681,397,154,141.1,99,6,2,91,4,11,30,19,2,615,97,3020,0.0324499988555908,375,0.00266999989748001,2.91606027998348,4.57910687542416,95.5671678980001,1621.50937357256,99
"316",2021-01-10,11934,1665,397,118,142.7,93,5,3,83,5,11,34,23,0,620,88,1824,0.0509899997711182,78,0,4.88989272252994,4.45979681580545,85.7776456704148,1566.19068228683,93
"317",2021-01-11,12098,1716,397,66,135.7,164,2,25,135,3,13,34,21,0,623,137,1608,0.0342000007629395,115,0,3.1917354165297,4.22049348474822,156.693211478711,1649.52956859466,164
"318",2021-01-12,12238,1744,398,159,143.3,140,1,22,115,4,13,35,22,1,627,116,2211,0.0705600023269653,74,0.0135099995136261,6.87124311198813,4.40654481768167,128.326633664212,1598.56594060677,140
"319",2021-01-13,12327,1732,402,172,149,89,0,9,76,2,11,34,23,4,629,76,2532,0.0375200009346008,173,0.0115600001811981,3.58597125315181,4.22416243401708,81.6924628776133,1656.62296978982,89
"320",2021-01-14,12419,1720,402,130,140.7,92,2,14,75,9,10,41,31,0,638,77,2581,0.0337100005149841,146,0,3.19052113418313,4.00189724280395,88.0184871726901,1653.39997320814,92
"321",2021-01-15,12514,1688,404,144,134.7,95,6,7,80,5,11,41,30,2,643,86,2923,0.0372900009155273,206,0.00485000014305115,3.51542897748658,4.02297898512182,89.3308868012651,1615.98298744809,95
"322",2021-01-16,12575,1639,405,119,129.7,61,0,0,59,2,9,39,30,1,645,59,2470,0.0323900008201599,289,0,2.89972098679938,4.02064480038124,56.9236882836047,1581.32076435302,61
"323",2021-01-17,12655,1578,407,74,123.4,80,2,3,72,2,9,39,30,2,647,74,2036,0.026029999256134,32,0,2.5627213967838,3.68819175384607,74.6984657303561,1528.92133679057,80
"324",2021-01-18,12776,1599,408,63,123,121,2,45,72,7,10,43,33,1,654,74,1021,0.0391799998283386,48,0,3.74207481990026,3.7668116686133,115.639309505754,1526.38183648244,121
"325",2021-01-19,12850,1541,415,81,111.9,74,3,24,47,8,9,45,36,7,662,50,2337,0.0410799980163574,89,0,3.95729412053699,3.35053324126313,71.598665472691,1466.99086986834,74
"326",2021-01-20,12911,1499,415,166,111,61,1,8,50,2,7,37,30,0,664,51,3065,0.0225099992752075,163,0.00612999975681305,2.16828803404187,3.14800706710457,57.6579413968349,1459.55400301677,61
"327",2021-01-21,12982,1467,417,81,104,71,1,9,60,3,7,37,30,2,667,61,2636,0.0242799997329712,117,0,2.32481217929938,3.02433435926404,68.2789161142814,1425.60934327296,71
"328",2021-01-22,13061,1437,418,95,97,79,1,3,74,5,6,37,31,1,672,75,2311,0.0307200002670288,111,0.00901000022888184,2.97250332958338,2.94677355242072,75.2943728743237,1385.16018427204,79
"329",2021-01-23,13109,1371,418,84,92,48,1,4,40,4,9,39,30,0,676,41,2122,0.0329900002479553,276,0,2.91929860409346,2.9495703548913,43.5473977666542,1322.42639848983,48
"330",2021-01-24,13155,1287,419,44,87.7,46,2,9,35,2,8,37,29,1,678,37,1247,0.0224499988555908,36,0,2.18200690357925,2.8951825701478,45.0201893051095,1252.91847663989,46
"331",2021-01-25,13218,1228,419,29,82.9,63,1,18,43,4,7,38,31,0,682,44,825,0.0206100010871887,48,0,1.94768051511234,2.63884052660667,60.9599487813014,1198.97311598723,63
"332",2021-01-26,13280,1165,420,74,81.9,62,1,19,40,8,5,40,35,1,690,41,2354,0.024210000038147,79,0,2.3423896461076,2.40813988740247,58.8344596107672,1131.88159625716,62
"333",2021-01-27,13358,1124,422,80,69.6,78,0,27,50,1,4,30,26,2,691,50,2800,0.0196399998664856,175,0.00570999979972839,1.88205880978528,2.36724999822296,75.8579436694106,1098.32657368835,78
"334",2021-01-28,13396,1063,422,66,67.4,38,1,3,33,3,5,30,25,0,694,34,2355,0.0212299990653992,209,0.0287100005149841,2.18397183723271,2.34712994935629,36.0988226203617,1034.82495427778,38
"335",2021-01-29,13425,961,422,73,64.3,29,1,2,26,3,4,31,27,0,697,27,2847,0.0122899997234344,180,0.00555999994277954,1.18898015204223,2.09234092399327,28.6103966340672,947.13300612365,29
"336",2021-01-30,13444,864,423,42,58.3,19,1,6,12,2,5,33,28,1,699,13,2155,0.0157799994945526,216,0,1.43424288953019,1.88019010762709,18.7737178018033,848.960936981391,19
"337",2021-01-31,13486,805,424,25,55.6,42,3,5,34,4,6,32,26,1,703,37,922,0.0195200002193451,24,0,1.90247782264653,1.84025738177955,41.145709340166,786.413405914422,42
"338",2021-02-01,13526,714,424,26,55.1,40,6,7,25,4,5,29,24,0,707,31,548,0.0292000007629395,29,0,2.77324097367259,1.9581945901453,36.9566413205928,689.969093642041,40
"339",2021-02-02,13568,651,425,59,53,42,4,5,31,3,5,27,22,1,710,35,2439,0.0221399998664856,107,0.0280399990081787,2.23879574109322,1.94339546085754,39.0490299320069,633.311956735329,42
"340",2021-02-03,13631,636,425,54,49.3,63,4,22,36,2,4,26,22,0,712,40,2865,0.0129100000858307,212,0,1.20205233168362,1.84625167827158,61.416463941313,626.721776666877,63
"341",2021-02-04,13713,638,425,51,47.1,82,3,43,33,2,5,25,20,0,714,36,2814,0.0127900004386902,90,0,1.23936161275738,1.71130736048939,78.4585169425984,628.403716927161,82
"342",2021-02-05,13771,637,427,72,47,58,1,8,48,2,5,21,16,2,716,49,2435,0.0160199999809265,149,0,1.50962461120573,1.75711371179847,56.1022624753405,625.329412179427,58
"343",2021-02-06,13796,606,427,61,49.7,25,1,4,19,3,6,21,15,0,719,20,2369,0.0143499994277954,205,0.0146300005912781,1.43722994427581,1.75754043390498,23.6511485086781,595.429799812946,25
"344",2021-02-07,13821,561,429,33,50.9,25,1,2,19,3,4,23,19,2,722,20,1004,0.0249000000953674,75,0,2.31692308579693,1.81674690006933,21.4376250808178,545.225383516938,25
"345",2021-02-08,13868,558,431,24,50.6,47,1,7,38,2,5,21,16,2,724,39,852,0.0140799999237061,29,0,1.36165266004513,1.61509142669397,45.3555113446727,548.778854623779,47
"346",2021-02-09,13923,577,431,43,48.3,55,5,8,39,0,2,19,17,0,724,44,2244,0.0178299999237061,149,0,1.67198160588368,1.5341179788069,51.1071705583394,565.291759367314,55
"347",2021-02-10,13980,594,432,40,46.3,57,0,6,50,3,4,20,16,1,727,50,2791,0.0125399994850159,100,0,1.21062395581734,1.53534249654028,55.2653785601619,585.272697294724,57
"348",2021-02-11,14040,620,433,51,46.3,60,1,11,46,1,3,16,13,1,728,47,2563,0.0152199995517731,58,0,1.48831968146488,1.57090793492707,57.1510572299861,608.801180480667,60
"349",2021-02-12,14091,623,435,52,43.4,51,0,8,41,3,2,16,14,2,731,41,2612,0.0157000005245209,173,0,1.47247401687786,1.56560070716595,48.2673174842542,611.866799821716,51
"350",2021-02-13,14124,622,435,46,41.3,33,0,3,29,6,2,21,19,0,737,29,2099,0.0219199991226196,46,0.0217400002479553,2.19161390068926,1.67336984379644,31.2286590729491,605.456067012908,33
"351",2021-02-14,14165,597,437,48,43.4,41,0,4,35,4,2,21,19,2,741,35,1175,0.0170200002193451,10,0,1.6876371525511,1.58347185333275,38.2831447781273,584.772498072628,41
"352",2021-02-15,14227,619,438,34,44.9,62,2,8,51,4,2,23,21,1,745,53,867,0.0265300011634827,26,0,2.57575711184093,1.75691534644643,59.3432189885009,599.650048186454,62
"353",2021-02-16,14278,614,438,61,47.4,51,3,13,32,3,2,24,22,0,748,35,1561,0.0333100008964539,23,0,3.28263329541442,1.98700844495083,46.6056405455675,589.538951285099,51
"354",2021-02-17,14335,629,439,49,48.7,57,5,6,44,2,2,25,23,1,750,49,2063,0.0184200000762939,222,0,1.66303983183345,2.0516392843817,54.0110301256629,616.304856102898,57
"355",2021-02-18,14407,645,439,68,51.1,72,3,12,53,3,3,26,23,0,753,56,2348,0.0212899994850159,116,0,2.02877105482213,2.12884662343274,66.6211869086337,629.119027786942,72
"356",2021-02-19,14461,649,440,58,52,54,2,16,33,1,3,26,23,1,754,35,2576,0.0151400005817413,96,0,1.45960484650321,2.12700817052207,50.3800057349384,637.503534913572,54
"357",2021-02-20,14509,627,440,66,54.9,48,0,3,44,4,3,26,23,0,758,44,2384,0.0255900001525879,68,0,2.48803264126303,2.16935370488975,45.6714035692048,608.067500861169,48
"358",2021-02-21,14551,616,440,53,55.6,42,0,7,33,2,4,24,20,0,760,33,1000,0.03,28,0,2.91828793774319,2.34516095991719,38.8312371166833,594.183092844755,42
"359",2021-02-22,14616,631,440,32,55.3,65,0,11,54,1,6,23,17,0,761,54,863,0.0150600004196167,66,0,1.39900757396439,2.17705388307769,64.0831502799339,620.286441234042,65
"360",2021-02-23,14671,637,440,47,53.3,55,0,7,47,3,6,25,19,0,764,47,2036,0.019650000333786,84,0,1.88714154149001,1.97769791823135,52.9235678412422,622.410908827049,55
"361",2021-02-24,14717,643,441,60,54.9,46,2,10,34,1,6,24,18,1,765,36,2874,0.0187899994850159,41,0,1.85257147581254,2.00477386737122,45.1906026001999,628.543263109125,46
"362",2021-02-25,14750,639,441,43,51.3,33,1,5,25,1,6,23,17,0,766,26,2376,0.0185199999809265,128,0.00781000018119812,1.79725239528254,1.97169977315127,30.432890724873,625.062198968995,33
"363",2021-02-26,14815,642,441,56,51,65,5,12,43,1,6,21,15,0,767,48,2639,0.0181900000572205,181,0,1.70224858691506,2.00636316463868,59.0083725257559,628.736982531985,65
"364",2021-02-27,14861,647,442,71,51.7,46,0,4,34,3,6,23,17,1,770,34,2535,0.0209100008010864,47,0.0212800002098083,2.09167358794017,1.94974044273542,37.136907861675,630.575864308934,46
"365",2021-02-28,14926,658,442,49,51.1,65,2,8,54,7,6,28,22,0,777,56,1552,0.0257699990272522,94,0,2.42983222905804,1.87996105578039,62.3486138175691,638.596212356437,65
"366",2021-03-01,15003,673,442,54,54.3,77,4,7,64,3,6,29,23,0,780,68,996,0.0291199994087219,45,0,2.78612098089213,2.07812011391293,72.700712836941,650.243819695019,77
"367",2021-03-02,15066,682,443,61,56.3,63,1,6,54,3,4,29,25,1,783,55,2006,0.0259200000762939,41,0,2.54008403287961,2.17139761268287,59.3045104975539,660.975930169669,63
"368",2021-03-03,15125,692,443,65,57,59,0,5,51,6,5,32,27,0,789,51,2676,0.0209299993515015,109,0,2.01108360016581,2.19404220187619,54.755242843703,675.110353879264,59
"369",2021-03-04,15182,688,443,61,59.6,57,3,3,50,1,5,31,26,0,790,53,2414,0.0202999997138977,225,0.00444000005722046,1.89477829944008,2.2079744738987,54.7812388469854,672.179100504263,57
"370",2021-03-05,15255,692,444,51,58.9,73,1,10,57,1,2,28,26,1,791,58,2440,0.0188499999046326,154,0,1.77309174122218,2.218094924514,66.751916816196,677.109076496684,73
"371",2021-03-06,15311,705,446,46,55.3,56,3,3,47,0,2,26,24,2,791,50,1957,0.0209500002861023,25,0,2.06857470029779,2.21479508342224,51.7447635432595,687.301165959959,56
"372",2021-03-07,15351,696,447,54,56,40,1,0,38,2,5,25,20,1,793,39,1752,0.0194099998474121,16,0.0625,1.97999545999242,2.15053268784143,38.0628413184884,679.275321991486,40
"373",2021-03-08,15434,738,448,38,53.7,83,1,9,65,6,4,29,25,1,799,66,1170,0.0205100011825562,142,0,1.82901687374929,2.01380352967817,73.5349718186813,721.618321245254,83
"374",2021-03-09,15491,745,448,70,55,57,0,8,47,1,3,27,24,0,800,47,2105,0.0318300008773804,57,0,3.09908195406502,2.0936603755618,53.2322727762394,716.979642942518,57
"375",2021-03-10,15571,768,448,76,56.6,80,5,8,64,0,2,24,22,0,800,69,2655,0.0180799996852875,173,0,1.69739742448509,2.04884806475027,75.5785978735462,752.179176331645,80
"376",2021-03-11,15632,765,451,73,58.3,61,1,7,52,1,2,20,18,3,801,53,2321,0.0280100011825562,86,0,2.70092283941474,2.16401157046093,58.2627097666564,739.92401833004,61
"377",2021-03-12,15714,770,451,93,64.3,82,5,4,67,2,2,17,15,0,803,72,2361,0.0228699994087219,133,0,2.16503883736938,2.22000401276768,74.1081682101745,749.767910025477,82
"378",2021-03-13,15782,789,451,56,65.7,68,5,3,54,5,4,22,18,0,808,59,2353,0.0187000000476837,99,0,1.79449837325448,2.18085025176149,60.7150701690258,771.816785819683,68
"379",2021-03-14,15850,814,451,65,67.3,68,2,10,51,2,3,23,20,0,810,53,1535,0.0299699997901916,36,0,2.92832270387932,2.31632557231676,61.1164414031797,785.071383060156,68
"380",2021-03-15,15957,861,452,58,70.1,107,4,3,97,4,5,25,20,1,814,101,1000,0.0320000004768372,13,0,3.15893390689409,2.50631371990887,100.12790285617,827.991330288738,107
"381",2021-03-16,16043,878,453,85,72.3,86,7,4,72,5,6,27,21,1,819,79,1583,0.0341100001335144,9,0,3.39171672181867,2.54811868673083,79.7481463262171,841.859145245805,86
"382",2021-03-17,16131,905,454,77,72.4,88,3,5,76,3,5,27,22,1,822,79,2842,0.0267400002479553,175,0,2.51889561500461,2.66547557109076,81.584975211274,877.334209698772,88
"383",2021-03-18,16224,942,455,63,71,93,6,3,80,2,5,24,19,1,824,86,2566,0.0284500002861023,161,0,2.67703339692477,2.66206279359219,86.2059345721348,911.395236825011,93
"384",2021-03-19,16349,992,457,117,74.4,125,7,6,104,2,4,24,20,2,826,111,2615,0.0382399988174438,97,0,3.6872270246171,2.87951824891329,112.032850995178,947.608902587539,125
"385",2021-03-20,16452,1046,458,83,78.3,103,5,6,87,4,4,27,23,1,830,92,1997,0.0435699987411499,151,0.00662000000476837,4.09724895189927,3.20848261729112,93.4252800679199,993.987423380915,103
"386",2021-03-21,16535,1072,459,87,81.4,83,5,1,75,4,4,29,25,1,834,80,1306,0.0421099996566772,87,0,3.94800140356213,3.35415100296009,77.1668870514172,1020.63628648899,83
"387",2021-03-22,16684,1148,460,55,81,149,6,6,134,4,7,30,23,1,838,140,1150,0.0547800016403198,131,0,4.91779874210521,3.60541740799025,137.644294620871,1079.48321589114,149
"388",2021-03-23,16808,1186,461,108,84.3,124,2,0,120,5,9,31,22,1,843,122,1966,0.0350999999046326,153,0,3.25656440832976,3.58610993463469,117.178259494778,1139.12635869513,124
"389",2021-03-24,16962,1277,461,85,85.4,154,7,2,138,4,9,33,24,0,847,145,3106,0.0457200002670288,47,0,4.50384779033909,3.86967453111105,139.074329039427,1207.19943574723,154
"390",2021-03-25,17111,1359,462,124,94.1,149,7,4,132,8,10,40,30,1,855,139,3005,0.0379399991035461,282,0,3.46850311244771,3.98274163332861,137.148850159054,1301.79343428888,149
"391",2021-03-26,17260,1443,463,104,92.3,149,10,2,130,4,11,42,31,1,859,140,2390,0.0673600006103516,117,0,6.42163547900839,4.37337141252737,131.08916429309,1330.54045767807,149
"392",2021-03-27,17377,1498,465,137,100,117,7,3,101,5,13,44,31,2,864,108,2476,0.0626000022888184,117,0,5.97753974805686,4.64198438340702,103.165152288404,1389.32776044472,117
"393",2021-03-28,17514,1557,466,140,107.6,137,3,5,124,5,13,45,32,1,869,127,2480,0.0826599979400635,157,0,7.77386404593695,5.18853618946057,120.018119239614,1410.10402878803,137
"394",2021-03-29,17723,1705,466,111,115.6,209,7,1,189,4,12,47,35,0,873,196,1644,0.0839400005340576,40,0,8.19461762933437,5.65665317335045,177.507430280396,1535.43453381671,209
"395",2021-03-30,17931,1835,467,170,124.4,208,9,6,185,6,12,48,36,1,879,194,1968,0.0406500005722046,64,0,3.93696855935525,5.75385376635409,190.730677175716,1747.32367328577,208
"396",2021-03-31,18137,1936,468,163,135.6,206,7,5,189,8,14,54,40,1,887,196,3023,0.0793900012969971,224,0,7.3913142568778,6.16634897585962,183.418251224322,1762.33537944024,206
"397",2021-04-01,18373,2071,469,143,138.3,236,11,4,204,4,15,53,38,1,891,215,2634,0.0721299982070923,100,0.01,6.98575037591372,6.66881287064048,200.772132880879,1895.41901021535,236
"398",2021-04-02,18570,2163,470,242,158,197,14,7,162,6,15,57,42,1,897,176,3130,0.0939299964904785,99,0,9.10501359601108,7.05215260164086,163.551881248855,1923.98704057542,197
"399",2021-04-03,18821,2341,470,223,170.3,251,14,3,225,11,14,61,47,0,908,239,2885,0.101909999847412,36,0,10.0654005326869,7.63613271373086,212.804676379899,2055.03241592194,251
"400",2021-04-04,19049,2500,471,152,172,228,9,2,213,12,15,64,49,1,920,222,1818,0.0929599952697754,139,0,8.63573180380438,7.7592566791405,200.733210974646,2237.98661007485,228
"401",2021-04-05,19334,2645,472,184,182.4,285,7,4,270,5,17,67,50,1,925,277,2045,0.105620002746582,162,0,9.78671978326961,7.98669984398839,248.099594256854,2330.84269606274,285
"402",2021-04-06,19608,2780,473,155,180.3,274,6,6,247,10,19,70,51,1,935,253,1749,0.128640003204346,83,0,12.2811880788428,9.17873120391518,221.290980967455,2365.64793316018,274
"403",2021-04-07,19918,2923,474,219,188.3,310,2,6,293,12,23,76,53,1,947,295,3364,0.098100004196167,44,0,9.68334548462165,9.50616423645002,266.331761615769,2579.49064136574,310
"404",2021-04-08,20213,3095,475,170,192.1,295,22,5,257,10,29,83,54,1,957,279,3366,0.0858600044250488,194,0.0103100001811981,8.1742953631985,9.6759563774907,256.321735159052,2787.95975024109,295
"405",2021-04-09,20508,3246,477,261,194.9,295,13,2,275,14,30,88,58,2,971,288,3418,0.110299997329712,158,0,10.542656344322,9.8813339129637,253.150901356341,2830.67995070376,295
"406",2021-04-10,20793,3408,480,380,217.3,285,13,2,259,14,26,92,66,3,985,272,3187,0.0875399971008301,97,0,8.49543150914572,9.65705262388639,245.9560826718,3056.62621229961,285
"407",2021-04-11,21064,3548,480,205,224.9,271,9,4,251,12,28,99,71,0,997,260,2714,0.145909996032715,29,0,14.43673821483,10.4857678254615,218.445974501411,2926.36275973464,271
"408",2021-04-12,21378,3642,481,265,236.4,314,17,3,291,16,27,99,72,1,1013,308,2125,0.0804699993133545,107,0,7.66123425362358,10.182127035512,282.362586562457,3303.37188396256,314
"409",2021-04-13,21616,3671,483,246,249.4,238,13,0,221,12,28,103,75,2,1025,234,2670,0.0767799997329712,178,0,7.19812497496605,9.45597516352965,213.558179458895,3350.30802048548,238
"410",2021-04-14,21890,3744,485,390,273.9,274,12,11,249,12,28,100,72,2,1037,261,3971,0.171490001678467,97,0.0103100001811981,16.7646722390061,10.4675932712989,218.896896208655,2982.2451318207,274
"411",2021-04-15,22115,3751,485,317,294.9,225,15,3,205,19,29,106,77,0,1056,220,3902,0.130959997177124,98,0.0101999998092651,12.8001377241611,11.1284278942935,188.823966671566,3168.2986317502,225
"412",2021-04-16,22352,3792,487,350,307.6,237,3,10,219,20,24,113,89,2,1076,222,2970,0.120539999008179,244,0.00409999996423721,11.1700123536268,11.2180501813371,201.905234814271,3277.94887574646,237
"413",2021-04-17,22533,3739,490,400,310.4,181,6,7,167,16,23,123,100,3,1092,173,2935,0.101870002746582,121,0.00825999975204468,9.81635857431989,11.4067540477905,159.389864436659,3293.55897762235,181
"414",2021-04-18,22695,3683,490,294,323.1,162,6,8,146,10,22,121,99,0,1102,152,1949,0.0646500015258789,188,0.0159599995613098,6.03665572725616,10.2067422638514,148.864125502724,3413.17483043773,162
"415",2021-04-19,22921,3621,491,257,322,226,6,4,216,22,22,115,93,1,1124,222,2084,0.112279996871948,88,0.0340899991989136,10.9112077997534,10.6710241990128,196.602518042904,3141.50323348359,226
"416",2021-04-20,23111,3510,492,188,313.7,190,8,2,180,17,27,118,91,1,1141,188,2775,0.100539999008179,221,0,9.31236639678558,10.9730586878442,168.752774090871,3113.30977159019,190
"417",2021-04-21,23306,3409,493,207,287.6,195,4,2,184,12,25,110,85,1,1153,188,2521,0.136850004196167,236,0.0211899995803833,12.6949474239937,10.3916694285567,161.035029730443,2883.77881037809,195
"418",2021-04-22,23483,3304,496,238,276.3,177,8,4,161,14,22,106,84,3,1167,169,2358,0.163269996643066,213,0.00939000010490417,15.0521478843522,10.7133851657268,142.127662570748,2700.43666943049,177
"419",2021-04-23,23691,3229,499,190,253.4,208,7,8,184,21,29,112,83,3,1188,191,2507,0.0805700016021729,86,0.0116299998760223,7.82835225630487,10.2360051518237,180.853701187982,2922.22304259682,208
"420",2021-04-24,23846,3108,500,227,228.7,155,3,2,148,18,31,118,87,1,1206,151,2464,0.0852299976348877,214,0.00467000007629395,7.87924175461875,9.95927417758068,138.56071447101,2810.79934156224,155
"421",2021-04-25,23995,2976,505,139,206.6,149,2,5,138,21,30,124,94,5,1227,140,1621,0.135719995498657,93,0.0215100002288818,12.9523070434428,10.9472243656073,122.993068177349,2508.19550639852,149
"422",2021-04-26,24157,2839,510,172,194.4,162,4,7,147,11,31,122,91,5,1238,151,1304,0.115030002593994,31,0,11.2358893919527,10.9936074502072,137.409412713164,2451.86968670644,162
"423",2021-04-27,24318,2744,511,189,194.6,161,3,5,149,10,31,119,88,1,1248,152,2425,0.0610300016403198,332,0.00903999984264374,5.47693267774876,10.4456883474877,146.896651774581,2561.6079767727,161
"424",2021-04-28,24484,2640,513,186,191.6,166,2,7,155,13,27,114,87,2,1261,157,2408,0.0689400005340576,38,0,6.78689784489006,9.60168126475859,151.068309677277,2422.54992068798,166
"425",2021-04-29,24609,2539,513,159,180.3,125,2,6,113,13,29,112,83,0,1274,115,2728,0.0652500009536743,111,0.00901000022888184,6.30511139933179,8.35210462404138,112.200156760325,2344.71476534318,125
"426",2021-04-30,24762,2446,516,178,178.6,153,4,3,139,13,27,109,82,3,1287,143,2122,0.0669199991226196,179,0,6.17141408684045,8.11539917126075,135.289615647943,2262.79999912496,153
"427",2021-05-01,24886,2391,520,136,165.6,124,3,5,113,7,29,110,81,4,1294,116,2051,0.089709997177124,70,0.0285700011253357,8.76921755252498,8.24253857096164,108.65465688213,2136.53693625148,124
"428",2021-05-02,24982,2328,520,128,164,96,0,4,90,8,27,108,81,0,1302,90,1279,0.0695900011062622,21,0,6.84658549345457,7.37029263524904,86.5217345615763,2134.56220065944,96
"429",2021-05-03,25088,2211,523,103,154.1,106,3,3,100,10,22,98,76,3,1312,103,976,0.174179992675781,140,0.0071399998664856,15.3225154868164,7.95409636308671,86.8463465722446,1799.8473036042,106
"430",2021-05-04,25194,2117,524,141,147.3,106,1,2,100,9,23,95,72,1,1321,101,2386,0.0389800000190735,57,0.0175399994850159,3.84797625935961,7.72138830331683,98.2833017965732,2018.13613765689,106
"431",2021-05-05,25276,2003,525,114,137,82,1,2,75,8,23,89,66,1,1329,76,1904,0.0777299976348877,65,0.0307699990272522,7.61797691384447,7.84011388459603,70.9735238625018,1817.81537232357,82
"432",2021-05-06,25381,1929,527,121,131.6,105,3,6,91,12,22,88,66,2,1341,94,2133,0.0534499979019165,246,0,4.79230119902429,7.62399814169496,94.532909152103,1816.80831653624,105
"433",2021-05-07,25494,1832,530,108,121.6,113,5,4,103,19,23,95,72,3,1360,108,2302,0.0469199991226196,82,0.0122000002861023,4.57257709747193,7.39559285749946,106.006657133502,1730.33514693126,113
"434",2021-05-08,25584,1758,534,136,121.6,90,1,3,86,4,21,86,65,4,1364,87,1901,0.0489200019836426,86,0.0116299998760223,4.73060411475805,6.81864808067561,85.0051760090031,1657.07010831986,90
"435",2021-05-09,25667,1695,537,69,113.1,83,0,5,78,4,22,83,61,3,1368,78,1173,0.172210006713867,123,0.00813000023365021,15.6637598691439,8.0782444200598,68.172260398479,1372.78181250541,83
"436",2021-05-10,25760,1627,538,82,110.1,93,4,3,85,9,22,85,63,1,1377,89,715,0.104899997711182,14,0,10.2885457288745,7.35910588321096,80.8870763636038,1423.84576678184,93
"437",2021-05-11,25892,1595,540,124,107.7,132,1,6,123,5,21,79,58,2,1382,124,1899,0.0458099985122681,86,0.0232599997520447,4.48330212360065,7.44986672095968,123.253103891843,1508.2153282862,132
"438",2021-05-12,25989,1535,541,117,108.1,97,3,3,90,8,22,80,58,1,1390,93,2118,0.0495800018310547,174,0.00574999988079071,4.62525933060347,7.02233563763954,90.7796049680781,1448.83541533333,97
"439",2021-05-13,26083,1508,541,78,102,94,1,1,91,7,20,77,57,0,1397,92,1684,0.0795699977874756,54,0.0185199999809265,7.76731624125886,7.44733778653019,84.3275232125728,1365.84679352782,94
"440",2021-05-14,26167,1430,541,128,104.9,84,2,5,75,7,21,70,49,0,1404,77,1738,0.0471799993515015,105,0,4.44920449663101,7.4297131292672,77.8422590792752,1352.78481147225,84
"441",2021-05-15,26242,1381,542,85,97.6,75,2,8,65,7,19,64,45,1,1411,67,1767,0.0458400011062622,61,0,4.43103292969176,7.3869172456863,71.3970012499048,1306.73520486744,75
"442",2021-05-16,26311,1353,543,47,94.4,69,2,3,63,7,19,67,48,1,1418,65,804,0.0398000001907349,20,0,3.88339807686296,5.7040084182176,64.9365584458534,1289.23328580369,69
"443",2021-05-17,26385,1320,545,88,95.3,74,7,5,59,10,19,71,52,2,1428,66,720,0.173610000610352,18,0,16.9375610351562,6.65386774768642,57.4331463555916,1048.66292711183,74
"444",2021-05-18,26464,1288,546,97,91.4,79,1,6,71,5,16,64,48,1,1433,72,1924,0.0285899996757507,56,0,2.77813936243154,6.41027306751941,75.5724350659688,1244.57356062455,79
"445",2021-05-19,26535,1273,550,91,87.7,71,2,5,64,4,14,57,43,4,1437,66,2012,0.0536800003051758,123,0.0162600004673004,5.1524187668146,6.48558155840671,66.8729529488345,1193.39801672525,71
"446",2021-05-20,26596,1229,553,74,87.1,61,5,9,45,11,15,63,48,3,1448,50,1493,0.0549200010299683,64,0.0156299996376038,5.33049977614318,6.13746492053304,55.7653874666945,1149.49322393135,61
"447",2021-05-21,26675,1190,554,77,79.9,79,4,10,62,3,13,59,46,1,1451,66,1678,0.0387400007247925,192,0.00521000027656555,3.52973482723542,6.00611211061939,73.1727100669762,1139.02310575306,79
"448",2021-05-22,26734,1156,558,78,78.9,59,0,13,46,8,15,58,43,4,1459,46,1362,0.0521299982070923,102,0.0196099996566772,4.98642606031699,6.08545398642299,56.2162415616213,1086.04294011379,59
"449",2021-05-23,26789,1132,559,39,77.7,55,0,4,51,5,12,59,47,1,1464,51,818,0.0293400001525879,13,0,2.88810109805257,5.94326870373579,53.2124141882446,1092.32260511947,55
"450",2021-05-24,26840,1086,561,65,74.4,51,2,10,39,5,11,57,46,2,1469,41,718,0.0668499994277954,30,0.0333299994468689,6.55056144018224,4.45941161873951,47.7405320701571,999.663849468065,51
"451",2021-05-25,26904,1024,563,56,68.6,64,1,14,48,3,11,54,43,2,1472,49,1021,0.0528900003433228,19,0.0526300001144409,5.28852503391413,4.81803814323702,59.8550410891527,958.276777046784,64
"452",2021-05-26,26960,982,566,79,66.9,56,1,11,44,1,8,47,39,3,1473,45,1367,0.0292600011825562,60,0.0333299994468689,2.94311293506422,4.50242302441554,54.3926747307318,946.924590790637,56
"453",2021-05-27,27003,932,566,62,65.1,43,0,8,34,3,9,42,33,0,1476,34,1364,0.0527899980545044,112,0,4.87842529446775,4.43784095560476,39.9870040223594,876.820227907027,43
"454",2021-05-28,27039,883,569,67,63.7,36,0,2,30,1,7,34,27,3,1477,30,1579,0.0303999996185303,195,0.00513000011444092,2.76222939233232,4.32819732204717,30.9943072296195,853.399109458469,36
"455",2021-05-29,27075,844,571,46,59.1,36,0,4,32,4,9,36,27,2,1481,32,1070,0.0224300003051758,104,0.00962000012397766,2.12952132363133,3.92006807394922,35.1729794470155,822.187332915032,36
"456",2021-05-30,27102,796,573,45,60,27,0,3,22,5,8,36,28,2,1486,22,700,0.0685699987411499,34,0,6.5393731769489,4.44167837093441,23.2540044454317,732.826706298347,27
"457",2021-05-31,27150,763,576,39,56.3,48,1,2,39,5,6,35,29,3,1491,40,765,0.0666699981689453,27,0.037039999961853,6.56598845937035,4.44388223081843,38.812542244647,702.199243316641,48
"458",2021-06-01,27191,727,577,38,53.7,41,1,5,35,2,5,31,26,1,1493,36,1559,0.0147500002384186,27,0.037039999961853,1.512946429424,3.90451385874841,40.3389864186074,713.651197953543,42
"459",2021-06-02,27222,688,577,50,49.6,31,0,1,29,1,6,30,24,0,1494,29,1652,0.0284500002861023,43,0.0232599997520447,2.83183365557398,3.88861681882123,29.0033330248282,664.354935209718,32
"460",2021-06-03,27266,674,577,48,47.6,44,1,5,38,2,5,29,24,0,1496,39,1171,0.0119599997997284,187,0,1.03130778832709,3.33902860365828,43.5118680488566,665.564078587931,46
"461",2021-06-04,27293,625,579,45,44.4,27,0,0,24,3,6,29,23,2,1499,24,1192,0.0453000020980835,67,0.0149300003051758,4.36838066095014,3.5684787848894,22.7276223006872,591.865164080397,30
"462",2021-06-05,27313,593,582,39,43.4,20,0,0,20,2,4,30,26,3,1501,20,998,0.0170299994945526,88,0,1.56500363679222,3.48783340105524,19.6201346522221,581.736992438385,25
"463",2021-06-06,27325,540,582,22,40.1,12,0,1,11,2,4,28,24,0,1503,11,594,0.0858600044250488,22,0,8.27935756955828,3.73640259999944,10.8947165790992,485.74063206487,20
"464",2021-06-07,27344,500,583,17,37,19,0,3,16,1,4,27,23,1,1504,16,643,0.00933000028133392,14,0,0.913118748995086,2.92884978423154,18.8226906759856,494.459083624551,27
"465",2021-06-08,27364,454,584,29,35.7,20,0,1,18,1,3,26,23,1,1505,18,1402,0.0349499988555908,53,0,3.3676906113772,3.19381323879629,18.2643198765153,435.444512440997,29
"466",2021-06-09,27379,415,585,33,33.3,15,0,0,14,2,4,24,20,1,1507,14,1190,0.0588199996948242,26,0,5.75623352276651,3.61158464839522,13.0219731645807,386.008490235784,27
"467",2021-06-10,27392,388,585,21,29.4,13,0,0,13,2,4,22,18,0,1509,13,1176,0.0272099995613098,134,0,2.44266866290842,3.81320763047827,12.614617274003,376.497807870242,26
"468",2021-06-11,27392,355,585,22,26.1,0,0,0,0,0,4,19,15,0,1509,0,NA,NA,NA,NA,NA,NA,NA,NA,26
