"","date","observed_cumulative_cases","observed_active_cases","observed_cumulative_deaths","observed_new_cases","observed_daily_average_cases","observed_new_episodes","observed_new_cases_community_outbreak","observed_new_cases_institution_outbreak","observed_new_cases_sporadic","observed_new_ICU_p_acute_care","observed_census_ICU","observed_census_ICU_p_acute_care","observed_census_acute_care","observed_new_deaths","cumulative_hosp","observed_new_community_cases","num_non_ltch_tests","non_ltch_pct_positivity","num_ltch_tests","ltch_pct_positivity","observed_pct_positivity","pct_positivity_7_day","adjusted_new_episodes","adjusted_active_cases","adjusted_episode_cases"
"1",2020-03-01,7,5,0,0,0,2,0,0,2,0,0,1,1,0,0,2,NA,NA,NA,NA,NA,NA,NA,NA,2
"2",2020-03-02,10,8,0,0,0,3,2,0,1,0,0,1,1,0,0,3,NA,NA,NA,NA,NA,NA,NA,NA,3
"3",2020-03-03,11,9,0,0,0,1,0,0,1,0,0,1,1,0,0,1,NA,NA,NA,NA,NA,NA,NA,NA,1
"4",2020-03-04,12,10,0,0,0,1,0,0,1,0,0,1,1,0,0,1,NA,NA,NA,NA,NA,NA,NA,NA,1
"5",2020-03-05,18,16,0,0,0,6,2,0,4,0,0,1,1,0,0,6,NA,NA,NA,NA,NA,NA,NA,NA,6
"6",2020-03-06,23,21,0,0,0,5,0,1,4,0,0,1,1,0,0,4,NA,NA,NA,NA,NA,NA,NA,NA,5
"7",2020-03-07,27,25,0,0,0,4,0,0,4,0,0,1,1,0,0,4,NA,NA,NA,NA,NA,NA,NA,NA,4
"8",2020-03-08,36,34,0,0,0,9,1,0,8,0,0,1,1,0,0,9,NA,NA,NA,NA,NA,NA,NA,NA,9
"9",2020-03-09,45,43,0,1,0.1,9,0,0,9,0,0,1,1,0,0,9,NA,NA,NA,NA,NA,NA,NA,NA,9
"10",2020-03-10,52,50,0,0,0.1,7,1,0,6,0,0,1,1,0,0,7,NA,NA,NA,NA,NA,NA,NA,NA,7
"11",2020-03-11,61,59,0,0,0.1,9,0,0,9,0,0,1,1,0,0,9,NA,NA,NA,NA,NA,NA,NA,NA,9
"12",2020-03-12,75,73,0,3,0.6,14,1,0,13,0,0,1,1,0,0,14,NA,NA,NA,NA,NA,NA,NA,NA,14
"13",2020-03-13,97,95,0,1,0.7,22,2,2,18,0,0,1,1,0,0,20,NA,NA,NA,NA,NA,NA,NA,NA,22
"14",2020-03-14,115,113,0,4,1.3,18,1,1,16,1,0,2,2,0,1,17,NA,NA,NA,NA,NA,NA,NA,NA,18
"15",2020-03-15,142,139,0,4,1.9,27,1,0,26,0,0,2,2,0,1,27,NA,NA,NA,NA,NA,NA,NA,NA,27
"16",2020-03-16,157,154,0,0,1.7,15,0,0,15,0,0,2,2,0,1,15,NA,NA,NA,NA,NA,NA,NA,NA,15
"17",2020-03-17,180,176,0,5,2.4,23,1,0,22,2,0,4,4,0,3,23,127,0,4,0,0,0,23,176,23
"18",2020-03-18,196,191,0,4,3,16,0,0,16,0,0,3,3,0,3,16,210,0.0190499997138977,1,0,1.89597153550641,0.947985767753204,15.5956187256855,186.17269853787,16
"19",2020-03-19,221,216,0,1,2.7,25,0,0,25,4,0,7,7,0,7,25,110,0.0272699999809265,9,0,2.52075630075791,1.47224261208811,24.1599403771634,208.741884858692,25
"20",2020-03-20,243,238,0,2,2.9,22,1,1,20,3,1,10,9,0,10,21,137,0.00730000019073486,4,0,0.709290798674238,1.28150465873464,21.8014440702044,235.749699462316,22
"21",2020-03-21,263,258,0,4,2.9,20,0,2,18,3,1,10,9,0,13,18,204,0.0147099995613098,3,0,1.44968111618705,1.31513995022512,19.6521562313031,253.014239315344,20
"22",2020-03-22,289,284,0,7,3.3,26,0,1,25,3,5,13,8,0,16,25,159,0.0314499998092651,2,0,3.10593165818208,1.61360523488462,24.9649266069298,272.241566254722,26
"23",2020-03-23,311,306,0,9,4.6,22,2,0,20,4,5,17,12,0,20,22,138,0.0362299990653992,3,0,3.54591480214545,1.88964945877902,20.9601032561709,291.535981654014,22
"24",2020-03-24,329,322,1,8,5,18,1,3,14,3,7,20,13,1,23,15,253,0.0197599995136261,4,0,1.94524508830638,2.16754161425136,17.6110401021988,313.650327527202,18
"25",2020-03-25,352,345,1,8,5.6,23,0,1,22,4,8,23,15,0,27,22,153,0.0588199996948242,2,0,5.80610319568265,2.7261318514194,21.2972665322153,318.298043346104,23
"26",2020-03-26,366,355,1,19,8.1,14,1,3,10,2,7,25,18,0,29,11,274,0.025550000667572,3,0,2.5273285858898,2.72707074929538,13.6294100516089,343.040051665558,14
"27",2020-03-27,383,363,1,27,11.7,17,3,2,12,5,9,26,17,0,34,15,577,0.0294600009918213,4,0,2.92571782655437,3.04370318184968,16.4149904741297,348.842769473939,17
"28",2020-03-28,408,385,2,26,14.9,25,1,1,23,3,8,25,17,1,37,24,367,0.0817399978637695,3,0,8.10772411243336,3.99485218131344,22.4061226023358,343.38988341247,25
"29",2020-03-29,427,397,2,11,15.4,19,5,4,10,7,8,31,23,0,44,15,184,0.0434800004959106,0,0,4.34800004959107,4.1722905229433,18.1305991902538,373.989858568718,19
"30",2020-03-30,452,406,3,48,21,25,8,2,14,4,12,32,20,1,48,22,549,0.0783199977874756,0,0,7.83199977874756,4.7845883767436,21.7031396629547,363.612486507255,25
"31",2020-03-31,469,403,3,51,27.1,17,2,3,12,6,13,34,21,0,54,14,943,0.064689998626709,0,0,6.4689998626709,5.43083905879567,15.7927299729238,368.247869934878,17
"32",2020-04-01,496,405,3,37,31.3,27,6,4,16,3,15,33,18,0,57,22,575,0.0573899984359741,4,0.25,5.87206374795943,5.44026199483521,24.277922535712,373.298119407426,27
"33",2020-04-02,513,401,6,32,33.1,17,5,4,7,6,14,34,20,3,63,12,107,0.0841100025177002,9,0,7.75842264602924,6.1875611462837,14.7589367334169,359.52780250835,17
"34",2020-04-03,540,406,6,26,33,27,3,4,19,5,14,37,23,0,68,22,217,0.110600004196167,2,0,10.9589958495745,7.33517229242944,22.7860975980828,346.688892037346,27
"35",2020-04-04,557,414,7,18,31.9,17,3,7,6,7,14,43,29,1,75,9,315,0.0253999996185303,3,0,2.51603769806196,6.53635994751924,15.6981446383949,400.114653366167,17
"36",2020-04-05,584,425,8,40,36,27,4,8,13,4,13,43,30,1,79,17,422,0.0663500022888184,5,0.2,6.79149905524153,6.88543123404074,23.4609461809039,386.523654522598,27
"37",2020-04-06,603,424,9,40,34.9,19,3,7,9,4,12,44,32,1,83,12,238,0.117650003433228,4,0.25,11.9837606682265,7.47853993253773,17.0830375142722,356.267325504286,19
"38",2020-04-07,626,422,9,25,31.1,23,2,11,10,4,14,45,31,0,87,12,285,0.108769998550415,6,0,10.6527318167932,8.07621592598378,21.2959533464771,362.07435935111,23
"39",2020-04-08,646,425,11,26,29.6,20,1,10,8,5,16,44,28,2,92,9,368,0.0434800004959106,6,0.333330001831055,4.81300005173301,7.92492111223715,18.4225722960589,397.732580647227,20
"40",2020-04-09,682,433,11,25,28.6,36,1,20,13,6,16,47,31,0,98,14,295,0.0949199962615967,5,0,9.33379963239034,8.14997496743159,32.2580898478691,379.125207437667,36
"41",2020-04-10,716,450,11,36,30,34,0,20,13,4,16,49,33,0,102,13,331,0.090629997253418,8,0,8.84912362562872,7.84856464972504,31.4665032650577,396.917420713535,34
"42",2020-04-11,760,480,11,31,31.9,44,0,34,8,5,19,53,34,0,107,8,225,0.102220001220703,11,0.363639984130859,11.4404830932617,9.12348542046786,40.7799613429345,406.797680576073,44
"43",2020-04-12,793,495,13,35,31.1,33,0,18,14,1,18,49,31,2,108,14,227,0.101319999694824,12,0.5,12.1337405567887,9.88666277783175,29.735553933915,414.935656949136,33
"44",2020-04-13,817,502,16,16,27.7,24,0,19,5,3,20,51,31,3,111,5,165,0.0606099987030029,26,0.0384599995613098,5.75948155737672,8.99748004771035,23.6161225182006,463.458700827344,24
"45",2020-04-14,850,502,18,32,28.7,33,0,26,7,5,20,50,30,2,116,7,208,0.0673099994659424,18,0.166669998168945,7.52236276812258,8.55028446932883,32.2980736361464,451.661852192212,33
"46",2020-04-15,879,500,24,60,33.6,29,2,18,9,4,16,50,34,6,120,11,390,0.1,24,0.208330001831055,10.6280000106148,9.38099874916909,27.4415837349269,429.162897042132,29
"47",2020-04-16,949,549,24,21,33,70,1,55,13,7,13,52,39,0,127,14,310,0.0354800009727478,11,0,3.42641753942424,8.5370870216025,68.3605485726681,523.924369028197,70
"48",2020-04-17,981,553,26,73,38.3,32,0,26,6,0,13,49,36,2,127,6,378,0.0846599960327148,66,0.5,14.6399726352176,9.36435116582949,30.8290704766742,445.079328933475,32
"49",2020-04-18,1021,575,31,31,38.3,40,0,31,9,1,11,46,35,5,128,9,421,0.0617600011825562,8,0,6.06082995288022,8.59582928863213,39.2728670089233,528.544281125655,40
"50",2020-04-19,1038,578,35,38,38.7,17,0,13,4,5,15,47,32,4,133,4,452,0.0442500019073486,47,0.127659997940063,5.21062540386865,7.60681283821498,16.7221636373052,537.852645590597,17
"51",2020-04-20,1099,614,39,16,38.7,61,1,47,13,3,13,45,32,4,136,14,325,0.0523099994659424,43,0.0232599997520447,4.89155701515467,7.48282361789754,60.0871185197873,573.963626510673,61
"52",2020-04-21,1135,627,47,51,41.4,36,0,26,10,2,11,43,32,8,138,10,543,0.069980001449585,25,0.36,8.27449661745152,7.59027131065882,34.8969865106708,557.84105421906,36
"53",2020-04-22,1176,644,54,35,37.9,41,1,31,9,4,9,45,36,7,142,10,656,0.0243899989128113,122,0.106560001373291,3.7275269221524,6.60448944087848,40.503110259505,612.000300712125,41
"54",2020-04-23,1221,659,57,50,42,45,0,35,10,5,11,48,37,3,147,10,775,0.0361299991607666,105,0.0285700011253357,3.522795394063,6.61825770582687,44.5304015435086,628.053461717219,45
"55",2020-04-24,1262,666,65,38,37,41,0,36,5,7,10,48,38,8,154,5,517,0.0406199979782104,94,0.106379995346069,5.07369206501887,5.25164619579848,40.661831344724,620.955935117241,41
"56",2020-04-25,1363,738,78,53,40.1,101,0,95,6,4,9,48,39,13,158,6,557,0.0502699995040894,28,0.0357100009918213,4.95731106864081,5.09400064090713,100.603505960618,689.231233155999,101
"57",2020-04-26,1417,757,87,88,47.3,54,0,41,13,5,9,50,41,9,163,13,358,0.0502799987792969,81,0.0123500001430511,4.32815252268233,4.96793308645194,53.2499587481586,713.324520950467,54
"58",2020-04-27,1478,781,95,87,57.4,61,0,54,7,8,11,56,45,8,171,7,269,0.0632000017166138,80,0.1,7.16355314090805,5.29250396155957,60.3315548633498,706.420621182318,61
"59",2020-04-28,1499,777,103,65,59.4,21,0,14,7,7,13,61,48,8,178,7,503,0.0616300010681152,11,0.272730007171631,6.61477054788909,5.05540023733637,20.3827628390801,708.486675137887,21
"60",2020-04-29,1524,766,111,29,58.6,25,0,17,8,7,13,62,49,8,185,8,668,0.0314400005340576,74,0.148649997711182,4.31294072606172,5.13903078075198,24.5400583726638,721.960589182558,25
"61",2020-04-30,1544,756,122,30,55.7,20,0,10,10,2,11,56,45,11,187,10,603,0.0414599990844727,6,0.333330001831055,4.43355656139956,5.26913951894292,19.4089945383972,711.319987102829,20
"62",2020-05-01,1567,740,135,42,56.3,23,0,16,7,6,11,57,46,13,193,7,516,0.031010000705719,55,0.0909099960327148,3.67797025323123,5.06975068868754,22.6568014112331,703.719006330356,23
"63",2020-05-02,1588,741,139,22,51.9,21,0,15,6,4,12,57,45,4,197,6,508,0.0511800003051758,28,0.0357100009918213,5.03718660126871,5.08116147906296,20.5971173817813,691.243996649991,21
"64",2020-05-03,1607,722,148,23,42.6,19,0,13,6,3,12,52,40,9,200,6,826,0.0205800008773804,231,0.0043299999833107,1.70286761786764,4.70612077837514,18.863801796782,705.610816212773,19
"65",2020-05-04,1625,719,152,14,32.1,18,0,11,7,6,10,52,42,4,206,7,637,0.0109899997711182,24,0.125,1.51295459216373,3.89889241426881,17.8588232516446,704.499131133212,18
"66",2020-05-05,1650,719,156,29,27,25,0,24,1,3,9,50,41,4,209,1,923,0.0292499995231628,29,0.172409992218018,3.36109656871868,3.4340818458159,24.9551956448152,686.78566862215,25
"67",2020-05-06,1666,692,161,23,26.1,16,0,11,5,4,10,52,42,5,213,5,598,0.0167200005054474,149,0.0134200000762939,1.60617674881196,3.04740127763736,15.8929460786503,677.183737285198,16
"68",2020-05-07,1689,670,167,32,26.4,23,0,16,7,6,10,54,44,6,219,7,813,0.0356699991226196,234,0.0128199994564056,3.05631224063884,2.85065208895726,22.7148095347164,642.703198322855,23
"69",2020-05-08,1702,637,173,16,22.7,13,0,8,5,4,8,54,46,6,223,5,715,0.00978999972343445,127,0.0472399997711182,1.54386339349022,2.54577968042283,12.8970993507261,623.890457282502,13
"70",2020-05-09,1719,621,179,12,21.3,17,0,12,5,5,6,51,45,6,228,5,1100,0.0154499995708466,164,0.0304900002479553,1.74013920637626,2.0747729097239,16.8840172939405,606.594947907416,17
"71",2020-05-10,1731,552,185,25,21.6,12,0,8,4,3,5,52,47,6,231,4,907,0.0176400005817413,316,0.0126600003242493,1.6353262984548,2.06512414980778,11.9128025763962,539.966755542675,12
"72",2020-05-11,1751,533,188,14,21.6,20,0,14,6,1,5,51,46,3,232,6,517,0.00967000007629394,197,0.0152300000190735,1.12040616851561,2.00904580357234,19.9103880387266,525.039470773543,20
"73",2020-05-12,1774,516,193,13,19.3,23,0,17,6,4,6,51,45,5,236,6,835,0.0131700003147125,322,0.00310999989509583,1.03702422031165,1.67703546808562,22.9170570665518,508.866907723452,23
"74",2020-05-13,1795,498,195,21,19,21,0,15,6,2,7,47,40,2,238,6,1249,0.0144099998474121,224,0.0133899998664856,1.42548878340193,1.65122290159847,20.8859870203828,488.536922691775,21
"75",2020-05-14,1809,470,198,25,18,14,0,10,4,2,6,45,39,3,240,4,1046,0.0267700004577637,127,0.0236199998855591,2.6428951802461,1.59216332154237,13.859077878959,453.441650777683,14
"76",2020-05-15,1829,456,201,17,18.1,20,0,12,8,1,5,44,39,3,241,8,1163,0.012039999961853,137,0.0146000003814697,1.23097846214588,1.54746547420746,19.8687257087319,448.517365397717,20
"77",2020-05-16,1845,436,207,19,19.1,16,0,6,10,1,4,42,38,6,242,10,967,0.0134399998188019,25,0.04,1.4109354662078,1.50043636846911,15.8119183650981,427.799640718279,16
"78",2020-05-17,1857,396,212,15,17.7,12,0,9,3,1,2,42,40,5,243,3,353,0.0254999995231628,10,0.1,2.7552341134095,1.66042319917693,11.8898158812365,381.455696323222,12
"79",2020-05-18,1872,388,213,26,19.4,15,0,8,7,2,1,43,42,1,245,7,376,0.0398900008201599,17,0.0588199996948242,4.07088557333133,2.08192025700774,14.6201377152054,366.944776214244,15
"80",2020-05-19,1884,351,219,23,20.9,12,0,8,4,0,1,40,39,6,245,4,359,0.0390000009536743,31,0.225809993743896,5.38490003805894,2.70304537382879,11.7128711192828,325.804440717064,12
"81",2020-05-20,1899,337,223,17,20.3,15,0,9,6,3,1,41,40,4,248,6,675,0.0296300005912781,36,0.0555600023269653,3.0942912071566,2.94144572007945,14.752513408426,323.099503106592,15
"82",2020-05-21,1907,323,229,11,18.3,8,0,1,7,0,1,38,37,6,248,7,478,0.0209200000762939,36,0,1.94547860631683,2.8418147809467,7.81846359100443,314.62339141349,8
"83",2020-05-22,1914,307,233,7,16.9,7,0,3,4,1,1,36,35,4,249,4,514,0.00583999991416931,14,0,0.568515143159664,2.74717716394867,6.96968613798353,304.673411090236,7
"84",2020-05-23,1923,303,236,6,15,9,1,3,5,1,0,35,35,3,250,6,582,0.00859000027179718,43,0,0.799900825309753,2.65988650096323,8.93602259270385,299.769140931544,9
"85",2020-05-24,1933,300,237,8,14,10,0,3,7,1,1,36,35,1,251,7,332,0.0150600004196167,25,0.04,1.68064989896716,2.50637447032861,9.84317527499576,293.278940356961,10
"86",2020-05-25,1948,296,240,6,11.1,15,1,7,7,0,1,35,34,3,251,8,401,0.0174600005149841,8,0,1.71184846124906,2.16936916860257,14.8174446585222,289.24545236532,15
"87",2020-05-26,1954,286,243,16,10.1,6,0,2,4,1,1,35,34,3,252,4,1123,0.00800999999046326,41,0.0731699991226196,1.03051545990701,1.54731422886658,5.94505176540444,282.071201226418,6
"88",2020-05-27,1959,259,243,8,8.9,5,0,1,4,1,1,33,32,0,253,4,1150,0.00957000017166138,13,0.0769199991226196,1.03228376491871,1.25274173711831,4.94495747740741,255.43599666213,5
"89",2020-05-28,1963,234,244,4,7.9,4,0,2,2,1,1,31,30,1,254,2,1403,0.00284999996423721,88,0,0.268179071081476,1.01312751779898,3.99285019629267,233.163472966243,4
"90",2020-05-29,1970,224,247,7,7.9,7,0,2,4,2,1,32,31,3,256,4,1380,0.0065200001001358,37,0,0.634975309681539,1.0226218273021,5.96614240772097,222.103974832374,7
"91",2020-05-30,1973,206,248,15,9.1,3,1,1,1,0,1,31,30,1,256,2,1020,0.0127499997615814,119,0,1.1417910234252,1.07146328417574,2.96955921407529,202.864599049755,3
"92",2020-05-31,1977,191,249,10,9.4,4,0,1,3,3,1,34,33,1,259,3,1309,0.00535000026226044,11,0.0909099960327148,0.606300022701422,0.917984730423489,3.97575355452283,189.456309637953,4
"93",2020-06-01,1988,182,250,5,9.3,11,0,5,6,0,1,31,30,1,259,6,763,0.00130999997258186,20,0,0.127653892602805,0.691671220616882,10.9897900279365,181.690297514074,11
"94",2020-06-02,1991,163,251,8,8.1,3,0,1,2,0,1,26,25,1,259,2,858,0.0104900002479553,9,0,1.03811075118174,0.692756262227556,2.97232338799786,160.744356121826,3
"95",2020-06-03,2001,154,251,8,8.1,10,0,7,3,0,0,22,22,0,259,3,1110,0.00449999988079071,141,0,0.399280564962245,0.602327233662347,9.98403243594596,153.180331711893,10
"96",2020-06-04,2008,144,254,8,8.7,7,0,2,5,0,0,20,20,3,259,5,1430,0.00559000015258789,21,0,0.550909732474203,0.642717328147022,6.9632810976658,142.942495612775,7
"97",2020-06-05,2012,135,256,15,9.9,4,0,1,3,1,0,21,21,2,260,3,1366,0.00952000021934509,29,0,0.932209340474939,0.685179332546079,3.96272016806724,133.322407563026,4
"98",2020-06-06,2015,126,257,2,8,3,0,0,3,0,0,21,21,1,260,3,1404,0.000710000023245811,68,0,0.0677201109128478,0.5317406307586,2.99729181607211,125.886256275029,3
"99",2020-06-07,2016,116,258,4,7.1,1,0,0,1,0,0,20,20,1,260,1,870,0.00230000004172325,22,0,0.22432735832951,0.477173107276898,0.997009653714267,115.653119830855,1
"100",2020-06-08,2019,108,258,0,6.4,3,0,0,3,0,0,19,19,0,260,3,701,0.0014300000667572,12,0,0.140593274445554,0.479021590397291,2.99437755725604,107.797592061217,3
"101",2020-06-09,2029,105,259,3,5.7,10,0,3,7,0,0,18,18,1,260,7,1338,0.00224000006914139,10,0,0.222338285794598,0.362482666770557,9.9792531802435,104.688797703652,10
"102",2020-06-10,2039,103,259,7,5.6,10,0,4,6,0,0,17,17,0,260,6,1281,0.00233999997377396,12,0,0.231828303666236,0.338560915156841,9.98145798411861,102.681695394036,10
"103",2020-06-11,2046,102,260,5,5.1,7,0,2,5,0,0,16,16,1,260,5,1529,0.00326999992132187,6,0,0.325721816267175,0.306391212841551,6.9782901864777,101.557119804145,7
"104",2020-06-12,2050,105,260,10,4.4,4,0,2,2,0,0,16,16,0,260,2,1596,0.00814999997615814,13,0,0.808415162333648,0.288706330249938,3.97844720059099,103.868478031027,4
"105",2020-06-13,2053,103,260,6,5,3,0,3,0,0,0,16,16,0,260,0,1479,0.00270000010728836,23,0.0434800004959106,0.332446083228058,0.326524326294968,3,102.543545296874,3
"106",2020-06-14,2056,100,260,1,4.6,3,0,1,2,0,0,16,16,0,260,2,768,0,13,0,0,0.294477560819324,3,100,3
"107",2020-06-15,2061,98,260,2,4.9,5,0,2,3,0,0,14,14,0,260,3,720,0.00555999994277954,17,0,0.543175028331244,0.351989239945851,4.97827797589333,97.2904138791821,5
"108",2020-06-16,2065,97,260,3,4.9,4,0,1,3,1,0,14,14,0,261,3,1250,0.000799999982118607,14,0,0.0791139222822989,0.331528616586951,3.99683616801702,96.8977027658837,4
"109",2020-06-17,2068,87,260,8,5,3,0,0,3,1,1,6,5,0,262,3,1098,0.0091100001335144,26,0,0.889927059305944,0.425542724535481,2.96441107188817,85.967921084757,3
"110",2020-06-18,2070,73,260,2,4.6,2,0,0,2,0,1,6,5,0,262,2,1304,0.00230000004172325,122,0,0.210322584460527,0.409057119991674,1.99439268251603,72.795332911835,2
"111",2020-06-19,2073,71,260,5,3.9,3,0,0,3,0,1,5,4,0,262,3,1875,0.0010700000077486,19,0,0.105926611115556,0.308701612674804,2.9957639061441,70.8997457787438,3
"112",2020-06-20,2079,71,261,1,3.1,6,0,0,6,1,1,5,4,1,263,6,1792,0.000560000017285347,158,0,0.0514625656910432,0.268561110169516,5.99588393783136,70.9512932643378,6
"113",2020-06-21,2085,75,261,1,3.1,6,0,0,6,0,1,4,3,0,263,6,1102,0.00363000005483627,86,0,0.336722227308887,0.316664285499357,5.97306839247995,74.6633549059993,6
"114",2020-06-22,2087,74,262,6,3.7,2,0,1,1,0,1,1,0,1,263,1,509,0.0039300000667572,10,0,0.385427752211834,0.294128960339441,1.99486214050828,73.619798397613,2
"115",2020-06-23,2096,79,262,4,3.9,9,0,0,9,0,1,1,0,0,263,9,1255,0.00158999994397163,20,0,0.156505876837992,0.305184953847398,8.98122359689497,78.8351849060781,9
"116",2020-06-24,2098,73,263,3,3.1,2,0,0,2,1,1,2,1,1,264,2,1733,0.00289000004529953,24,0,0.285052366448724,0.218774283439223,1.9924003448211,72.72261258597,2
"117",2020-06-25,2104,71,263,6,3.7,6,0,0,6,0,1,2,1,0,264,6,1796,0.00277999997138977,21,0.0476200008392334,0.32982388366758,0.235845897611659,5.9736201335544,70.6878382470604,6
"118",2020-06-26,2108,65,263,6,3.9,4,0,0,4,0,1,2,1,0,264,4,2028,0.00196999996900558,23,0,0.194790830674955,0.248540786120145,3.98961353548063,64.8312199515602,4
"119",2020-06-27,2111,67,263,3,4.1,3,0,0,3,0,1,1,0,0,264,3,1574,0.000640000030398369,80,0,0.0609044768952257,0.249889630577885,2.99756437898225,66.9456044639368,3
"120",2020-06-28,2113,66,263,2,4.3,2,0,0,2,0,1,1,0,0,264,2,880,0.00114000000059605,12,0,0.112466367771807,0.217853079215445,1.99700158386707,65.9010522676134,2
"121",2020-06-29,2117,67,263,1,3.6,4,0,0,4,2,1,3,2,0,266,4,854,0.00351000010967255,8,0,0.347742470262222,0.212469467508358,3.98145798333144,66.6894212208016,4
"122",2020-06-30,2120,66,263,10,4.4,3,0,0,3,0,1,3,2,0,266,3,1605,0.00435999989509583,11,0,0.433032167798812,0.251973223359904,2.98268268109308,65.6190189840477,3
"123",2020-07-01,2122,65,263,4,4.6,2,0,0,2,0,2,3,1,0,266,2,1601,0.00312000006437302,15,0,0.309103966773589,0.255409166263456,1.9917591157331,64.7321712613257,2
"124",2020-07-02,2128,64,263,4,4.3,6,0,1,5,0,1,3,2,0,266,5,1012,0.00197999998927116,12,0,0.195679686439689,0.236245709516614,5.98695767587387,63.8330582511856,6
"125",2020-07-03,2136,72,263,4,4,8,0,0,8,0,1,3,2,0,266,8,1334,0.00300000011920929,14,0,0.296884284794154,0.2508304886765,7.96833959709818,71.7150563738836,8
"126",2020-07-04,2139,72,263,4,4.1,3,0,0,3,0,1,3,2,0,266,3,1257,0.00317999988794327,40,0,0.308192741645697,0.286157383640853,2.98767511425535,71.7042027421284,3
"127",2020-07-05,2141,69,263,5,4.6,2,0,0,2,0,1,2,1,0,266,2,734,0.00272000014781952,47,0,0.255631255889824,0.306609510514855,1.99318472804869,68.7648731176798,2
"128",2020-07-06,2147,69,263,0,4.4,6,0,1,5,0,1,2,1,0,266,5,602,0,10,0,0,0.256932014763109,6,69,6
"129",2020-07-07,2154,70,263,6,3.9,7,0,1,6,0,1,1,0,0,266,6,1272,0.0039300000667572,21,0,0.386617175940848,0.250301301640543,6.96907771094838,69.6392399610645,7
"130",2020-07-08,2167,76,263,5,4,13,0,1,12,0,1,1,0,0,266,12,1684,0.00296999990940094,39,0,0.29027741424441,0.247611794136374,12.9535662527844,75.7059196009679,13
"131",2020-07-09,2175,80,263,5,4.1,8,0,0,8,1,0,2,2,0,267,8,1504,0.00266000002622604,41,0,0.258941102876632,0.256649139341652,7.97238594272311,79.7238594272311,8
"132",2020-07-10,2191,93,263,12,5.3,16,0,0,16,0,0,2,2,0,267,16,1900,0.00684000015258789,14,0.0714300012588501,0.73124453017455,0.318700602967423,15.8440369017098,92.0934644911885,16
"133",2020-07-11,2198,98,263,7,5.7,7,0,0,7,1,1,2,1,0,268,7,1571,0.00381999999284744,25,0,0.376016290022765,0.328389681307004,6.96491318547892,97.5087845967049,7
"134",2020-07-12,2221,118,263,9,6.3,23,0,2,21,1,1,3,2,0,269,21,1068,0.00842999994754791,13,0,0.832862159480219,0.410851238962775,22.7668520150321,116.68993037018,23
"135",2020-07-13,2244,136,263,6,7.1,23,0,2,21,0,0,3,3,0,269,21,808,0.00619000017642975,65,0,0.572911814725686,0.492695783923587,22.839621438377,134.961357886632,23
"136",2020-07-14,2263,146,263,4,6.9,19,0,2,17,1,0,4,4,0,270,17,1406,0.00356000006198883,66,0,0.340038049399205,0.486041622989067,18.9229423645194,145.338210895284,19
"137",2020-07-15,2284,166,263,15,8.3,21,0,0,21,1,0,5,5,0,271,21,1404,0.00782999992370606,46,0,0.758159992612641,0.552881991327386,20.7877638303663,164.322323611467,21
"138",2020-07-16,2306,184,263,7,8.6,22,0,1,21,0,0,5,5,0,271,21,1695,0.00708000004291534,25,0.04,0.75584884143846,0.623868811121932,21.7884108044581,182.146075620014,22
"139",2020-07-17,2336,211,263,17,9.3,30,0,0,29,0,1,5,4,0,271,29,1787,0.00726999998092651,21,0,0.718555860946664,0.622056144089377,28.722222045896,208.97892592014,30
"140",2020-07-18,2362,230,263,16,10.6,26,0,0,24,2,1,6,5,0,273,24,1551,0.00708999991416931,81,0,0.673810653607635,0.664598196030073,23.7844299830062,227.934120670476,26
"141",2020-07-19,2380,248,263,28,13.3,18,0,0,18,0,1,6,5,0,273,18,2025,0.0212299990653992,22,0,2.10018310246377,0.845644045027723,17.4960715172754,241.056985349128,18
"142",2020-07-20,2410,273,263,47,19.1,30,0,0,27,2,3,8,5,0,275,27,1548,0.0148599994182587,35,0.0285700011253357,1.51631264301018,0.980415591925508,26.4542524921053,267.481886309064,30
"143",2020-07-21,2434,292,263,23,21.9,24,0,0,23,0,3,8,5,0,275,23,1428,0.0161099994182587,15,0,1.59425358068423,1.15958923925194,22.511207562433,285.79446122741,24
"144",2020-07-22,2461,312,263,13,21.6,27,0,1,23,2,3,9,6,0,277,23,1771,0.00902999997138977,16,0,0.894914938406899,1.17912566007969,23.7256222852758,308.278006652437,27
"145",2020-07-23,2480,320,263,29,24.7,19,0,1,17,1,3,10,7,0,278,17,1667,0.0101999998092651,32,0,1.0007886805206,1.21411706566285,17.7732065294665,315.730946437016,19
"146",2020-07-24,2503,335,263,34,27.1,23,0,1,18,0,3,7,4,0,278,18,2036,0.0122800004482269,83,0,1.17989999587494,1.28002337065261,18.7168888684085,329.730987273157,23
"147",2020-07-25,2515,334,263,26,28.6,12,0,1,10,0,3,7,4,0,278,10,2126,0.00800000011920929,320,0,0.695339339878943,1.28309889726279,10.9073093256295,330.904131476026,12
"148",2020-07-26,2522,336,263,21,27.6,7,0,0,6,2,4,9,5,0,280,6,1816,0.0121099996566772,73,0,1.16420113163186,1.14938718714395,5.90688524424986,330.785573677992,7
"149",2020-07-27,2537,338,264,22,24,15,0,1,13,1,4,9,5,1,281,13,1601,0.00874000012874603,24,0,0.861091704992148,1.05578419599852,13.8507782946701,334.120235661423,15
"150",2020-07-28,2557,328,264,14,22.7,20,0,2,17,1,4,10,6,0,282,17,1488,0.00739000022411346,24,0,0.727269863325452,0.931929379232978,18.8351899261768,324.820135046235,20
"151",2020-07-29,2573,322,264,20,23.7,16,2,2,12,2,4,11,7,0,284,14,2254,0.00620999991893768,52,0,0.606996522865808,0.890798177012822,15.8867199375248,319.394558563071,16
"152",2020-07-30,2593,332,264,19,22.3,20,1,0,18,1,4,12,8,0,285,19,1891,0.00898999989032745,134,0,0.839510607042431,0.867758452230227,18.7873726974648,328.284617660964,20
"153",2020-07-31,2603,319,264,18,20,10,0,1,9,1,3,13,10,0,286,9,2129,0.00797999978065491,207,0,0.727286795077667,0.803099423544901,9.91274557663112,315.90731543837,10
"154",2020-08-01,2620,306,264,15,18.4,17,0,0,17,1,2,13,11,0,287,17,1629,0.00551999986171722,83,0.0120500004291534,0.583658283315251,0.787144986892945,16.8677344276018,303.619219696832,17
"155",2020-08-02,2628,291,264,2,15.7,8,0,0,8,0,2,13,11,0,287,8,1340,0.00149000003933907,11,0,0.147786828476266,0.641942943585003,7.98423968268854,290.426718457796,8
"156",2020-08-03,2637,277,264,10,14,9,0,1,7,0,1,12,11,0,287,7,1046,0.0114699995517731,47,0,1.09767790769942,0.675740972543185,7.89757353026113,272.946838268905,9
"157",2020-08-04,2649,265,264,20,14.9,12,0,1,11,1,1,11,10,0,288,11,1699,0.0058899998664856,12,0,0.584869069150148,0.655398001946712,11.914238853087,262.933936006187,12
"158",2020-08-05,2658,245,264,12,13.7,9,1,0,8,1,1,12,11,0,289,9,1599,0.005,70,0,0.479029358897543,0.637116978522675,8.94252964474227,243.435529217984,9
"159",2020-08-06,2668,221,264,12,12.7,10,0,0,10,1,2,10,8,0,290,10,1639,0.00305000007152557,10,0,0.303150401287472,0.560494091986252,9.95958920555839,220.10692144284,10
"160",2020-08-07,2680,222,264,6,11,12,0,3,9,1,2,10,8,0,291,9,1689,0,39,0,0,0.456595978403728,12,222,12
"161",2020-08-08,2686,205,264,14,10.9,6,1,1,4,0,1,10,9,0,291,5,1518,0.00725000023841858,95,0,0.682300084433937,0.470687664277826,5.95452374738339,203.135473642719,6
"162",2020-08-09,2688,196,264,16,12.9,2,0,1,1,2,2,12,10,0,293,1,1589,0.00441000014543533,102,0,0.414399185753799,0.508775143888902,1.99447594321461,194.917284870063,2
"163",2020-08-10,2700,197,264,8,12.6,12,2,0,10,0,1,12,11,0,293,12,1384,0.00578000009059906,27,0,0.566939767922686,0.432955409635084,11.9093104162488,195.511179333418,12
"164",2020-08-11,2713,201,264,8,10.9,13,2,1,10,0,1,12,11,0,293,12,1460,0.00342000007629395,41,0,0.332658235269098,0.396925290509219,12.9467868747354,200.108680151818,13
"165",2020-08-12,2720,184,264,12,10.9,7,3,0,4,0,2,10,8,0,293,7,1486,0.00268999993801117,7,0,0.267738774808078,0.366740921353581,6.97501677192968,183.343298005009,7
"166",2020-08-13,2742,187,264,11,10.7,22,0,0,22,0,2,9,7,0,293,22,1689,0.00532999992370605,56,0,0.515895121555274,0.397133024248982,21.848705429488,185.713996150648,22
"167",2020-08-14,2753,182,264,6,10.7,11,4,1,6,1,2,10,8,0,294,10,1882,0.00477999985218048,36,0,0.469028139822923,0.464137044223685,10.937477240125,180.862085770274,11
"168",2020-08-15,2757,174,264,2,9,4,0,0,4,1,2,11,9,0,295,4,2044,0.00734000027179718,21,0,0.726535620123653,0.470456406465073,3.96126030976751,172.314823474887,4
"169",2020-08-16,2761,156,264,26,10.4,4,0,1,3,0,2,11,9,0,295,3,1196,0.00501999974250793,22,0,0.492932651234769,0.481675472962354,3.98028721061426,154.974934951942,4
"170",2020-08-17,2784,170,265,8,10.4,23,1,4,18,1,1,9,8,1,296,19,1358,0.00662999987602234,32,0,0.647736678535132,0.493217888764132,22.8359442971242,168.532133184796,23
"171",2020-08-18,2810,189,265,15,11.4,26,1,1,24,0,1,7,6,0,296,25,1888,0.00583000004291534,77,0.0519500017166138,0.76372469278389,0.554798811266246,25.74548341814,187.075854641138,26
"172",2020-08-19,2834,198,265,23,13,24,4,3,15,2,1,7,6,0,298,19,1519,0.0118499994277954,25,0.04,1.23057960691847,0.692347501567731,21.6883245784164,194.752014027707,24
"173",2020-08-20,2851,206,266,24,14.9,17,1,0,16,3,0,6,6,1,301,17,1607,0.00995999991893768,103,0,0.936007009925898,0.752363485620677,16.7878870111577,203.429689664616,17
"174",2020-08-21,2872,213,266,16,16.3,21,3,2,16,0,0,6,6,0,301,19,1804,0.00721000015735626,116,0.00861999988555908,0.729518764093518,0.789576431945048,20.8152309147058,210.928641306965,21
"175",2020-08-22,2891,223,266,16,18.3,19,1,0,18,1,0,7,7,0,302,19,1864,0.00589999973773956,73,0,0.567764559171221,0.766894851808986,18.8561992598081,221.312233417748,19
"176",2020-08-23,2908,233,266,13,16.4,17,0,1,15,0,0,7,7,0,302,15,694,0.0172899997234344,5,0,1.71663230444399,0.941709087981732,15.656752185258,227.668217277675,17
"177",2020-08-24,2927,249,266,19,18,19,2,0,17,1,1,8,7,0,303,19,1142,0.00962999999523163,58,0,0.91645499954621,0.980097419554743,18.7678845832158,245.958066380039,19
"178",2020-08-25,2941,251,266,23,19.1,14,0,1,13,4,2,11,9,0,307,13,1647,0.0145700001716614,73,0,1.3951622257399,1.0703027814056,13.7582272766887,246.331926649912,14
"179",2020-08-26,2959,259,266,15,18,18,1,4,13,0,2,11,9,0,307,14,1832,0.0049099999666214,41,0,0.480251998870817,0.96311312311308,17.9103734957507,257.341909671389,18
"180",2020-08-27,2972,262,266,16,16.9,13,1,3,9,1,2,9,7,0,308,10,1469,0.00612999975681305,9,0,0.609267228874044,0.916436011534243,12.9187829782132,259.872114029186,13
"181",2020-08-28,3000,272,266,20,17.4,28,0,3,21,1,1,9,8,0,309,21,2137,0.00607999980449677,35,0,0.598202559033591,0.897676553668539,23.8325416521164,269.831015684555,28
"182",2020-08-29,3021,286,266,12,16.9,21,0,2,18,0,1,9,8,0,309,18,1790,0.00726000010967255,11,0.0909099960327148,0.777091068999096,0.927580340786807,19.813540865613,283.037371531407,21
"183",2020-08-30,3041,300,267,16,17.3,20,0,6,12,2,1,10,9,1,311,12,1402,0.00428000003099442,33,0,0.418157494317364,0.742083939340146,17.9331101269523,298.327753173806,20
"184",2020-08-31,3061,309,267,13,16.4,20,1,3,16,1,1,11,10,0,312,17,1353,0.00517000019550324,54,0,0.497157801315983,0.682184339592971,19.8873367121772,306.952179062515,20
"185",2020-09-01,3086,313,267,18,15.7,25,1,2,22,0,1,11,10,0,312,23,1361,0.0154299998283386,22,0.0909099960327148,1.6630693911127,0.720456791789084,24.490108881439,306.061046951756,25
"186",2020-09-02,3122,323,267,15,15.7,36,1,9,26,0,1,9,8,0,312,27,1528,0.00261999994516373,51,0,0.253537676770752,0.688069031489075,35.908747344492,321.908347861886,36
"187",2020-09-03,3144,324,267,24,16.9,22,1,4,17,1,1,8,7,0,313,18,1493,0.00938000023365021,133,0.00751999974250793,0.922785997207461,0.732857426965278,21.7785820927201,320.014477668961,22
"188",2020-09-04,3166,328,267,24,17.4,22,0,3,19,3,1,11,10,0,316,19,2705,0.00813000023365021,258,0.00774999976158142,0.809691210614641,0.763070091476856,21.7949252141007,324.459761590791,22
"189",2020-09-05,3191,335,267,17,18.1,25,1,11,13,2,1,13,12,0,318,14,2256,0.00398999989032745,164,0,0.371960320354493,0.705194270241913,24.930583311863,333.338957819578,25
"190",2020-09-06,3212,337,267,26,19.6,21,1,3,16,1,1,14,13,0,319,17,1310,0.00611000001430511,192,0.03125,0.932363516560566,0.778652273419513,19.7887126804736,332.811539607034,21
"191",2020-09-07,3253,362,267,29,21.9,41,2,6,33,0,1,12,11,0,319,35,1290,0.0147300004959106,44,0,1.4244153403092,0.91111763613283,40.3354251109256,355.126396861573,41
"192",2020-09-08,3305,399,267,24,22.7,52,0,14,36,3,1,14,13,0,322,36,1097,0.0127600002288818,4,0,1.27136423715562,0.855159756996105,49.3898849578701,392.237891616394,52
"193",2020-09-09,3350,430,267,15,22.7,45,2,10,31,0,1,13,12,0,322,33,1587,0.0144900000095367,29,0,1.42299690687715,1.02222536129702,42.3740247866171,421.843353280162,45
"194",2020-09-10,3427,492,267,33,24,77,1,21,52,2,2,14,12,0,324,53,1959,0.0127600002288818,61,0,1.23746734892968,1.06717984011448,73.1257233907554,483.884073740597,77
"195",2020-09-11,3457,506,267,60,29.1,30,0,1,25,0,1,12,11,0,324,25,2314,0.0155599999427795,93,0.0752699995040894,1.78670335776785,1.20675300399351,25.404568641405,493.948469302036,30
"196",2020-09-12,3506,531,269,47,33.4,49,0,4,42,1,0,12,12,2,325,42,1900,0.0168400001525879,26,0,1.66126688940379,1.39093965671484,45.0699036488819,519.240924703721,49
"197",2020-09-13,3541,544,270,31,34.1,35,1,5,29,1,1,11,10,1,326,30,1199,0.0166799998283386,44,0,1.6089557356539,1.48759568801389,34.356565131799,532.332381056622,35
"198",2020-09-14,3609,594,272,59,38.4,68,0,19,49,1,1,11,10,2,327,49,2394,0.0141999995708466,218,0.0412799978256226,1.6460121936674,1.51925238135077,66.9248517085628,580.966569691557,68
"199",2020-09-15,3682,643,273,41,40.9,73,0,15,55,1,1,11,10,1,328,55,2961,0.0121599996089935,28,0,1.20460886056306,1.5097158989804,69.1168225256503,632.674852436239,73
"200",2020-09-16,3759,683,274,41,44.6,77,0,7,67,1,0,11,11,1,329,67,1887,0.0190799999237061,162,0.00616999983787537,1.80592971350752,1.56442058564189,72.3870723489242,666.557767377839,77
"201",2020-09-17,3809,708,278,57,48,50,2,4,38,2,2,11,9,4,331,40,2512,0.0191100001335144,208,0.00481000006198883,1.80164707162801,1.6450176888845,43.0393416712142,690.996347580492,50
"202",2020-09-18,3897,776,278,47,46.1,88,1,6,78,0,2,11,9,0,331,79,2409,0.0128699994087219,281,0.0213499999046326,1.37558284568078,1.58628618715778,83.5513846477286,761.770563121992,88
"203",2020-09-19,3967,827,280,47,46.1,70,2,4,60,0,2,10,8,2,331,62,2101,0.0214199995994568,161,0,1.98954107685494,1.6331824996508,64.3556894600154,805.067019087625,70
"204",2020-09-20,4010,859,280,76,52.6,43,1,4,34,2,2,11,9,0,333,35,2847,0.0186199998855591,112,0,1.79152212484578,1.6592634123925,38.1641478551226,838.485800215722,43
"205",2020-09-21,4119,939,280,55,52,109,2,22,82,1,3,12,9,0,334,84,2949,0.0189900004863739,73,0,1.85312744653596,1.68885130565944,103.924972697435,915.804159082043,109
"206",2020-09-22,4228,1018,280,85,58.3,109,0,27,81,3,3,15,12,0,337,81,2507,0.0135599994659424,64,0.03125,1.4000357316654,1.71676943010263,106.488307774042,999.001201407099,109
"207",2020-09-23,4334,1077,281,67,62,106,0,26,75,2,3,16,13,1,339,75,1896,0.0168799996376038,7,0.571430015563965,1.89198578149472,1.7290631541008,99.1084476176415,1049.83730778933,106
"208",2020-09-24,4435,1130,282,38,59.3,101,2,18,75,2,3,18,15,1,341,77,2730,0.0128199994564056,55,0,1.25668217292594,1.65121102571479,93.710101848465,1111.07032582812,101
"209",2020-09-25,4554,1193,284,57,60.7,119,5,16,86,3,3,20,17,2,344,91,3291,0.0133700001239777,59,0.0339000010490417,1.37315732745982,1.65086452311179,105.33428409737,1171.16264756222,119
"210",2020-09-26,4640,1241,286,76,64.9,86,3,14,67,3,4,21,17,2,347,70,3437,0.0299699997901916,12,0,2.98657260883992,1.79329759910965,81.2131707598688,1191.5934987571,86
"211",2020-09-27,4722,1271,287,109,69.6,82,2,12,64,2,4,22,18,1,349,66,2684,0.0331599998474121,13,0,3.30001629923819,2.00879676687999,75.0966508822341,1215.08853441393,82
"212",2020-09-28,4837,1341,288,86,74,115,3,11,97,6,4,27,23,1,355,100,3135,0.0258400011062622,192,0.0104200005531311,2.49501182970644,2.10049453590435,107.674079606972,1296.3994075295,115
"213",2020-09-29,4944,1372,291,58,70.1,107,5,18,74,4,3,27,24,3,359,79,2165,0.0263299989700317,79,0.0253200006484985,2.62944419881239,2.27612431692535,94.230953230988,1323.90971940399,107
"214",2020-09-30,5027,1401,291,107,75.9,83,1,10,67,5,5,30,25,0,364,68,3170,0.0305999994277954,281,0.0142299997806549,2.92670611777675,2.42394150782278,75.3470609706057,1346.34165323263,83
"215",2020-10-01,5128,1437,293,105,85.4,101,2,11,78,3,5,29,24,2,367,80,3844,0.0226300001144409,120,0.00833000004291534,2.21971040476944,2.56151696951471,88.6328512710235,1394.48009095576,101
"216",2020-10-02,5224,1487,294,115,93.7,96,0,13,79,1,5,29,24,1,368,79,3362,0.021710000038147,197,0,2.05082945007727,2.65832727274577,89.8402878201043,1446.34820238601,96
"217",2020-10-03,5297,1500,295,65,92.1,73,2,6,64,5,6,31,25,1,373,66,3113,0.0301999998092651,485,0.0103100001811981,2.75188853513406,2.62480097650208,69.578892821676,1444.97483685627,73
"218",2020-10-04,5354,1481,295,77,87.6,57,1,7,47,3,6,32,26,0,376,48,3118,0.0291899991035461,102,0,2.82653469580301,2.55716074743991,53.1914321801074,1425.19814705706,57
"219",2020-10-05,5432,1482,295,82,87,78,3,13,59,3,6,33,27,0,379,62,3821,0.0177999997138977,238,0.00839999973773956,1.72488294763206,2.447142335715,73.5744233964173,1447.92412054017,78
"220",2020-10-06,5508,1455,296,140,98.7,76,5,15,53,2,7,34,27,1,381,58,2158,0.0194599997997284,55,0,1.89763576899295,2.34259827431222,71.5328311681963,1418.1942991332,76
"221",2020-10-07,5609,1469,296,174,108.3,101,12,22,63,3,10,36,26,0,384,75,2268,0.0313100004196167,76,0,3.02948297575472,2.35728068259479,93.9712109910381,1409.6761192778,101
"222",2020-10-08,5689,1428,296,85,105.4,80,5,14,55,2,9,36,27,0,386,60,2434,0.0271199989318848,182,0,2.52332100153698,2.40065362499015,71.9818056145679,1379.96697362672,80
"223",2020-10-09,5772,1429,296,97,102.9,83,5,19,57,2,9,37,28,0,388,62,2508,0.0207299995422363,247,0.00810000002384186,1.95976547578285,2.38764448580523,79.3802983184335,1391.66848866196,83
"224",2020-10-10,5837,1414,297,67,103.1,65,5,7,51,6,9,43,34,1,394,56,2628,0.0300600004196167,21,0,2.98216991705371,2.42054182607947,60.7738231980603,1357.78903575102,65
"225",2020-10-11,5901,1378,297,140,112.1,64,6,6,48,5,10,46,36,0,399,54,2660,0.0233100008964539,238,0.0168099999427795,2.2776184393012,2.34212521800778,58.3604903739164,1336.1621432455,64
"226",2020-10-12,5963,1350,297,62,109.3,62,2,14,43,3,10,46,36,0,402,45,1994,0.0150499999523163,237,0.0126600003242493,1.47961093598233,2.30708635920068,58.1124368000134,1323.3731040004,62
"227",2020-10-13,6048,1372,298,74,99.9,85,4,10,68,1,7,45,38,1,403,72,2117,0.0302300000190735,18,0,2.9975133508374,2.4642117280356,79.1230463609348,1317.17805010004,85
"228",2020-10-14,6115,1377,300,84,87,67,1,16,49,2,7,45,38,2,405,50,3004,0.0296300005912781,110,0.0363599991798401,2.98677333609447,2.45811035094128,64.0092738981047,1322.1754031538,67
"229",2020-10-15,6201,1403,300,107,90.1,86,3,25,52,5,8,49,41,0,410,55,2119,0.021710000038147,105,0.00952000021934509,2.11344829603708,2.39955710729843,78.4504929447471,1363.47348366327,86
"230",2020-10-16,6276,1424,301,78,87.4,75,2,10,59,4,8,47,39,1,414,61,3126,0.0214299988746643,280,0.0035699999332428,1.99617664308598,2.40475870262745,69.3768149068356,1386.1079414317,75
"231",2020-10-17,6323,1406,302,64,87,47,1,10,36,6,8,49,41,1,420,37,3037,0.0214000010490417,149,0,2.03991849296735,2.2701513563294,45.9938707380121,1367.76708804446,47
"232",2020-10-18,6380,1374,305,74,77.6,57,1,11,40,2,6,47,41,3,422,41,1144,0.0271000003814697,37,0.0540500020980835,2.79443272769098,2.34398196895651,50.472726709758,1322.81771949287,57
"233",2020-10-19,6444,1352,307,69,78.6,64,1,6,57,3,6,46,40,2,425,58,1334,0.0374799990653992,27,0,3.67364575703472,2.65741551482114,61.1596980611987,1285.79158239208,64
"234",2020-10-20,6522,1356,309,46,74.6,78,3,13,57,4,5,45,40,2,429,60,1595,0.0250799989700317,48,0.0208299994468689,2.49558358677117,2.58571126281168,71.0039904633099,1310.89018447081,78
"235",2020-10-21,6610,1380,312,69,72.4,88,1,46,40,4,4,44,40,3,433,41,2258,0.0305599999427795,446,0.00897000014781952,2.69989274913919,2.54472832181807,85.5243967258838,1330.33335321268,88
"236",2020-10-22,6676,1367,312,88,69.7,66,2,24,36,1,3,43,40,0,434,38,2238,0.0268099999427795,87,0.0114900004863739,2.62367354469915,2.61761764305551,60.6709765812069,1319.19013122394,66
"237",2020-10-23,6755,1369,313,92,71.7,79,1,13,64,2,3,36,33,1,436,65,2768,0.0245700001716614,65,0.0153799998760223,2.4359145946735,2.68043735042515,75.8893576157578,1324.54662424573,79
"238",2020-10-24,6820,1362,317,63,71.6,65,2,17,41,2,3,36,33,4,438,43,2358,0.0211999988555908,191,0,1.96114544140773,2.6691840573452,58.8758675121165,1326.39375701169,65
"239",2020-10-25,6890,1343,319,69,70.9,70,1,24,42,3,3,38,35,2,441,43,1751,0.0308400011062622,77,0,2.95409419787008,2.69199283879936,65.3067072997349,1290.11413729172,70
"240",2020-10-26,6963,1302,320,77,72,73,1,16,51,4,3,39,36,1,445,52,995,0.0392000007629395,121,0.0165299999713898,3.67420526484435,2.69207276848645,65.4531345631432,1238.23040771562,73
"241",2020-10-27,7041,1272,322,61,74.1,78,0,15,60,1,3,31,28,2,446,60,1354,0.0288000011444092,116,0,2.65273479928776,2.71452294170311,72.8782982923291,1227.01992379738,78
"242",2020-10-28,7153,1278,325,94,77.7,112,2,69,38,2,2,29,27,3,448,40,1900,0.0405299997329712,166,0.01807000041008,3.87253724882471,2.88204358451532,106.935119913216,1212.02708122726,112
"243",2020-10-29,7217,1263,326,65,74.4,64,0,18,42,9,2,37,35,1,457,42,2190,0.0292199993133545,96,0,2.79929127280168,2.90713183138712,58.4327559796945,1215.87073338938,64
"244",2020-10-30,7267,1232,328,122,78.7,50,1,9,36,4,2,40,38,2,461,37,2789,0.0358599996566772,105,0.0571400022506714,3.66320799166528,3.0824594595288,44.1932313639645,1171.83948757849,50
"245",2020-10-31,7306,1162,329,83,81.6,39,0,5,32,2,2,39,37,1,463,32,2352,0.0276399993896484,322,0,2.43116224997955,3.1496047178962,35.9629417211166,1124.34182124805,39
"246",2020-11-01,7356,1122,332,50,78.9,50,1,6,40,1,2,37,35,3,464,41,1714,0.0256699991226196,104,0,2.42015283257261,3.07332737999656,45.6772861830366,1085.80280725286,50
"247",2020-11-02,7420,1075,332,56,75.9,64,3,8,47,6,2,42,40,0,470,50,1030,0.0174800002574921,14,0.0714300012588501,1.82034677038704,2.80849045221695,56.7867134788846,1048.91433979602,64
"248",2020-11-03,7491,1003,333,36,72.3,71,1,36,33,1,2,43,41,1,471,34,1456,0.0219799995422363,13,0,2.17854862719511,2.74074957048943,69.0126175215519,973.872216885781,71
"249",2020-11-04,7556,927,337,53,66.4,65,5,1,51,1,1,40,39,4,472,56,1466,0.0272900009155273,295,0.0033899998664856,2.32863096551825,2.52019153001707,55.2616871674312,898.22471436087,65
"250",2020-11-05,7603,884,337,45,63.6,47,0,6,34,5,2,43,41,0,477,34,2536,0.0240499997138977,41,0,2.36673648717286,2.45839798921296,38.9273252341643,856.110456088271,47
"251",2020-11-06,7677,878,341,79,57.4,74,1,12,58,4,3,46,43,4,481,59,2342,0.0234800004959106,116,0.0258599996566772,2.35923194148077,2.27211569632945,69.144496012303,850.387584725458,74
"252",2020-11-07,7712,844,346,75,56.3,35,3,4,25,3,4,46,42,5,484,28,2499,0.0276099991798401,142,0,2.61254782091709,2.2980279207491,31.0248722382275,814.606863180858,35
"253",2020-11-08,7749,782,346,47,55.9,37,1,5,29,1,4,47,43,0,485,30,1176,0.0204099988937378,92,0.0108700001239777,1.97178223268467,2.23397497790797,34.2114677782028,761.445593418486,37
"254",2020-11-09,7819,750,350,31,52.3,70,3,24,41,7,4,46,42,4,492,44,711,0.0210999989509583,20,0.1,2.3258685710166,2.30619237799791,66.6358030079509,726.746642180981,70
"255",2020-11-10,7886,759,350,51,54.4,67,0,11,54,3,5,47,42,0,495,54,1374,0.0334800004959106,17,0,3.30708272332,2.46741153458718,62.6194458801442,725.53998931536,67
"256",2020-11-11,7942,758,353,78,58,56,0,6,48,2,5,46,41,3,497,48,2375,0.0261100006103516,241,0.0290499997138977,2.63808491516186,2.51161924167912,52.3120124119508,731.343862672057,56
"257",2020-11-12,7984,748,355,58,59.9,42,1,8,31,3,3,43,40,2,500,32,2318,0.0215700006484985,214,0.00467000007629395,2.01416435701211,2.4612517945133,39.1408200660039,727.91666904284,42
"258",2020-11-13,8022,724,357,81,60.1,38,1,7,26,0,3,36,33,2,500,27,2719,0.0217000007629395,200,0,2.02131901591067,2.41297851943186,33.2724918435003,704.492003507193,38
"259",2020-11-14,8043,701,357,50,56.6,21,3,2,14,3,3,37,34,0,503,17,1710,0.015789999961853,245,0.0163300001621246,1.58576726212221,2.26629558246116,18.6406417580102,686.181757197952,21
"260",2020-11-15,8073,657,360,29,54,30,1,1,25,0,2,35,33,3,503,26,984,0.0152400004863739,306,0.00653999984264374,1.31762794034426,2.17284496926967,26.5433269485501,645.460223276823,30
"261",2020-11-16,8117,618,363,11,51.1,44,0,3,39,3,2,33,31,3,506,39,735,0.0122399997711182,53,0,1.1416751055548,2.0036744742037,41.4064649379529,608.594752093716,44
"262",2020-11-17,8158,596,363,39,49.4,41,1,10,29,1,2,32,30,0,507,30,1828,0.020789999961853,38,0,2.03666237568421,1.82218585311287,39.1855216658675,579.819030428568,41
"263",2020-11-18,8199,588,363,66,47.7,41,3,6,30,1,2,32,30,0,508,33,2684,0.0204900002479553,20,0.05,2.07082694768906,1.74114900061676,38.0890448642622,571.768435763217,41
"264",2020-11-19,8219,572,364,53,47,20,1,1,17,0,2,30,28,1,508,18,2476,0.0121200001239777,187,0.0160399997234344,1.23952685900304,1.63048650090118,18.7025816993666,562.548707335428,20
"265",2020-11-20,8244,529,364,28,39.4,25,1,2,20,1,2,30,28,0,509,21,2643,0.00757000029087067,222,0.0225200009346008,0.872842966012306,1.46641849377284,22.7556599535676,522.844957877964,25
"266",2020-11-21,8273,497,365,27,36.1,29,4,4,19,2,2,31,29,1,511,23,1495,0.0187300002574921,71,0,1.7880811229215,1.49532047388702,26.4517807322313,485.153696692129,29
"267",2020-11-22,8300,483,368,26,35.7,27,3,4,19,3,4,31,27,3,514,22,1220,0.0147500002384186,36,0,1.4327229530948,1.51176261856567,25.5798308710545,473.775377759969,27
"268",2020-11-23,8340,466,370,20,37,40,2,10,25,1,3,27,24,2,515,27,922,0.0173500001430511,13,0,1.71087701945381,1.5930771776941,36.3842253614481,455.372185867956,40
"269",2020-11-24,8384,476,370,21,34.4,44,2,7,34,1,3,23,20,0,516,36,1403,0.00855000019073486,41,0.0975599956512451,1.10772923056108,1.46037244267651,42.4684117686963,468.971222274985,44
"270",2020-11-25,8439,484,371,38,30.4,55,4,10,39,2,2,23,21,1,518,43,2618,0.0122200000286102,72,0.0138900005817413,1.22646989281736,1.33975000626627,52.2969850053868,476.086994014121,55
"271",2020-11-26,8484,499,372,60,31.4,45,3,4,37,3,2,23,21,1,521,40,3059,0.0143799996376038,224,0.00446000009775162,1.37031553193196,1.35843410239897,43.2693324627529,489.884922472842,45
"272",2020-11-27,8530,510,374,56,35.4,46,2,3,40,3,1,24,23,2,524,42,3154,0.0177600002288818,336,0.00298000007867813,1.63370546556817,1.46712874519267,44.0853345106565,498.8933476294,46
"273",2020-11-28,8575,513,375,60,40.1,45,2,3,40,2,1,25,24,1,526,42,2597,0.0119400000572205,191,0,1.11220158352229,1.3705745252785,44.3773097861999,505.394283817156,45
"274",2020-11-29,8620,524,377,23,39.7,45,0,4,38,5,1,28,27,2,531,38,898,0.0245000004768372,12,0,2.41769235474723,1.51128443980027,40.7753164773918,507.112258793508,45
"275",2020-11-30,8664,531,378,45,43.3,44,1,7,35,1,1,25,24,1,532,36,1135,0.0229099988937378,61,0,2.17415123280873,1.57746647027955,41.9566464650842,515.610535359992,44
"276",2020-12-01,8717,552,378,34,45.1,53,2,11,39,3,1,27,26,0,535,41,1906,0.0141700005531311,113,0.0176999998092651,1.43675686145195,1.62447041754967,51.2147528343326,541.427891818332,53
"277",2020-12-02,8759,566,379,50,46.9,42,1,5,34,6,1,31,30,1,541,35,2859,0.0101400005817413,81,0.0123500001430511,1.0200888324757,1.59498740892943,39.5240675921523,558.303493061662,42
"278",2020-12-03,8797,565,380,40,44,38,0,6,31,3,1,33,32,1,544,31,3327,0.0102199995517731,202,0,0.963500666158941,1.53687099953329,36.6018442848258,557.743290997631,38
"279",2020-12-04,8839,568,382,54,43.7,42,1,5,32,2,1,31,30,2,546,33,2994,0.0110199999809265,165,0.0121200001239777,1.10774548791865,1.46173385986907,37.5127036363729,559.612595923025,42
"280",2020-12-05,8874,557,382,45,41.6,35,2,2,29,1,1,31,30,0,547,31,2277,0.0184500002861023,209,0,1.68988940673592,1.54426069175673,32.3016723818297,544.452629570295,35
"281",2020-12-06,8913,551,383,33,43,39,0,7,30,1,2,31,29,1,548,30,1397,0.0157500004768372,20,0,1.55276998349623,1.42070035300659,36.3790342844508,539.594929691079,39
"282",2020-12-07,8966,553,384,24,40,53,0,4,44,2,1,30,29,1,550,44,1068,0.0168499994277954,25,0.04,1.73795053878184,1.3583859681456,46.9806359108675,540.188446788857,53
"283",2020-12-08,9013,558,384,57,43.3,47,1,1,44,0,1,27,26,0,550,45,2367,0.01942999958992,69,0,1.88796424586785,1.4228441659193,44.8674809392306,543.95676364646,47
"284",2020-12-09,9068,569,386,39,41.7,55,2,2,48,1,3,24,21,2,551,50,2911,0.00962000012397766,167,0.00598999977111816,0.942305078709412,1.41173220109555,51.3719405173919,561.852683087919,55
"285",2020-12-10,9112,567,386,57,44.1,44,2,0,42,1,3,23,20,0,552,44,3091,0.0139100003242493,252,0.00397000014781952,1.3160709255012,1.46209938100158,43.228081921625,557.052782944576,44
"286",2020-12-11,9151,551,386,49,43.4,39,6,2,30,1,2,23,21,0,553,36,3047,0.0118099999427795,32,0,1.16872587936503,1.47081086549392,37.4391400841018,542.415727398336,39
"287",2020-12-12,9180,536,387,56,45,29,2,5,22,0,2,20,18,1,553,24,2616,0.0156700003147125,24,0,1.5527545766397,1.45122017548018,28.5032323566253,524.905522631299,29
"288",2020-12-13,9220,534,388,28,44.3,40,5,2,33,0,2,19,17,1,553,38,1502,0.0119799995422363,47,0,1.16165005244926,1.39534589961632,39.4115654642833,525.730946261244,40
"289",2020-12-14,9262,531,388,19,43.6,42,3,4,35,2,2,20,18,0,555,38,917,0.0174500000476837,20,0,1.70775347318313,1.39103203310222,41.1349364466585,518.91187508357,42
"290",2020-12-15,9310,541,389,51,42.7,48,2,7,38,1,1,20,19,1,556,40,2079,0.0134700000286102,49,0,1.31598355542672,1.30932050589635,46.2983028790853,531.509546439629,48
"291",2020-12-16,9364,557,389,54,44.9,54,3,3,46,0,1,18,17,0,556,49,2312,0.0168700003623962,94,0,1.62109064164007,1.4062898720293,50.9411300594676,544.963458022928,54
"292",2020-12-17,9402,553,390,60,45.3,38,1,5,30,1,0,17,17,1,557,31,3207,0.0134099996089935,83,0.0241000008583069,1.36796865706023,1.41370383368059,35.4347024780387,542.915821624367,38
"293",2020-12-18,9443,542,390,23,41.6,41,3,4,34,0,0,16,16,0,557,37,3298,0.00727999985218048,170,0.00587999999523163,0.72113724082124,1.34976259960291,40.6443204557433,536.789775324672,41
"294",2020-12-19,9482,539,390,46,40.1,39,1,7,28,3,0,19,19,0,560,29,2799,0.0117900002002716,140,0,1.12283805922287,1.28834595425765,35.5659354048409,530.932385627905,39
"295",2020-12-20,9526,534,390,24,39.6,44,4,2,34,0,0,16,16,0,560,38,1360,0.0161800003051758,51,0,1.55951810170369,1.34518424700828,39.2100251636171,522.898774667671,44
"296",2020-12-21,9600,554,390,28,40.9,74,6,8,59,1,0,15,15,0,561,65,1365,0.00658999979496002,32,0.03125,0.715486737302823,1.20343185616824,72.3800535386517,548.716148621739,74
"297",2020-12-22,9682,596,390,67,43.1,82,3,7,68,2,0,15,15,0,563,71,3021,0.0225099992752075,48,0,2.21579367254487,1.33197615861369,75.902862493514,578.395859804709,82
"298",2020-12-23,9782,663,390,52,42.9,100,5,6,88,1,1,13,12,0,564,93,2652,0.0199800002574921,199,0.0150800001621246,1.96379799070964,1.38093435133791,96.5654483045691,645.644002429348,100
"299",2020-12-24,9855,691,390,55,42.1,73,11,5,55,2,1,13,12,0,566,66,3469,0.01557000041008,144,0,1.49494413015686,1.39907370463743,69.6847505200498,677.22973650537,73
"300",2020-12-25,9918,720,390,52,46.3,63,5,2,54,0,1,10,9,0,566,59,2537,0.0295600008964539,161,0,2.77960423551903,1.69314041816568,58.8138788931503,693.321911916411,63
"301",2020-12-26,10011,763,390,86,52,93,5,4,83,2,2,12,10,0,568,88,951,0.0199800002574921,50,0,1.89819982466283,1.80390638465711,89.7732890642387,743.693404045615,93
"302",2020-12-27,10122,828,391,35,53.6,111,8,6,95,2,4,12,8,1,570,103,1480,0.0270300006866455,32,0.0625,2.77806885028012,1.97798506302517,105.185659400752,797.337145474007,111
"303",2020-12-28,10256,924,391,65,58.9,134,15,7,110,1,2,13,11,0,571,125,1188,0.04125,39,0.0256399989128113,4.07538385962507,2.45797036621406,125.209249487938,873.80277221484,134
"304",2020-12-29,10376,1001,391,112,65.3,120,5,15,100,3,4,12,8,0,574,105,1880,0.0505299997329712,25,0.04,5.03918107600976,2.8613114238519,112.946762556162,933.759136368748,120
"305",2020-12-30,10513,1092,391,88,70.4,137,12,10,115,3,5,13,8,0,577,127,2458,0.0573600006103516,62,0,5.59487625000969,3.38003688946619,127.528179766757,1010.55726224644,137
"306",2020-12-31,10639,1180,391,147,83.6,126,0,9,117,2,5,13,8,0,579,117,2652,0.0331800007820129,144,0,3.14711595400209,3.6160614357298,121.091623736194,1130.49671802315,126
"307",2021-01-01,10756,1236,392,88,88.7,117,0,5,111,2,6,13,7,1,581,111,2759,0.0391400003433228,134,0.0149300003051758,3.80186246070242,3.76209832504171,110.374532485068,1173.35965902291,117
"308",2021-01-02,10868,1295,392,133,95.4,112,2,8,100,2,6,15,9,0,583,102,2369,0.0295499992370605,431,0,2.50014100687844,3.84808992250108,106.600587116084,1251.84078740519,112
"309",2021-01-03,10991,1322,393,107,105.7,123,0,5,118,3,5,18,13,1,586,118,1516,0.0600299978256226,126,0.0238100004196167,5.72506313986087,4.26908910672691,113.99463066852,1221.10933681173,123
"310",2021-01-04,11167,1434,393,115,112.9,176,4,30,141,5,8,21,13,0,591,145,1386,0.0533900022506714,155,0.00644999980926514,4.86685873393035,4.38215694591337,165.59289517002,1340.96697706075,176
"311",2021-01-05,11310,1509,395,106,112,143,2,19,122,6,8,23,15,2,597,124,2417,0.0575099992752075,97,0.0103100001811981,5.56888378145397,4.45782876097683,133.794887922325,1396.97972479668,143
"312",2021-01-06,11494,1605,395,132,118.3,184,11,42,130,7,7,28,21,0,604,141,2627,0.0513899993896484,211,0.0142200005054474,4.86264793880394,4.35322471651887,173.860315991601,1500.96317139376,184
"313",2021-01-07,11610,1639,395,188,124.1,116,2,7,106,6,9,32,23,0,610,108,2311,0.048899998664856,91,0.0109899997711182,4.74637747267502,4.58169064775786,108.166782090274,1535.29959116629,116
"314",2021-01-08,11743,1671,395,186,138.1,133,6,13,113,0,11,30,19,0,610,119,2661,0.0368300008773804,249,0,3.36785678126148,4.51968983640915,126.657557986174,1595.98133945291,133
"315",2021-01-09,11843,1682,397,153,141,100,6,2,92,4,11,30,19,2,614,98,3020,0.0324499988555908,375,0.00266999989748001,2.91606027998348,4.57910687542416,96.1905540678083,1616.61746879647,100
"316",2021-01-10,11936,1666,397,120,142.9,93,4,3,83,5,11,34,23,0,619,87,1824,0.0509899997711182,78,0,4.88989272252994,4.45979681580545,84.3290237958833,1557.40406487289,93
"317",2021-01-11,12100,1717,397,66,135.9,164,2,25,135,3,13,34,21,0,622,137,1608,0.0342000007629395,115,0,3.1917354165297,4.22049348474822,156.171098844144,1643.94727529486,164
"318",2021-01-12,12240,1745,398,159,143.4,140,1,22,115,4,13,35,22,1,626,116,2211,0.0705600023269653,74,0.0135099995136261,6.87124311198813,4.40654481768167,127.374911777717,1585.16569872514,140
"319",2021-01-13,12329,1733,402,172,149.1,89,0,9,76,2,11,34,23,4,628,76,2532,0.0375200009346008,173,0.0115600001811981,3.58597125315181,4.22416243401708,81.367048191505,1650.15913836682,89
"320",2021-01-14,12421,1721,402,130,140.9,92,2,14,75,9,10,41,31,0,637,77,2581,0.0337100005149841,146,0,3.19052113418313,4.00189724280395,87.7251486477012,1647.80494574927,92
"321",2021-01-15,12516,1689,404,144,134.9,95,6,7,80,5,11,41,30,2,642,86,2923,0.0372900009155273,206,0.00485000014305115,3.51542897748658,4.02297898512182,88.9698981635925,1609.85067439893,95
"322",2021-01-16,12577,1640,405,119,130,61,0,1,58,2,9,39,30,1,644,58,2470,0.0323900008201599,289,0,2.89972098679938,4.02064480038124,56.7580627840837,1576.60729251547,61
"323",2021-01-17,12657,1579,407,74,123.4,80,2,3,72,2,9,39,30,2,646,74,2036,0.026029999256134,32,0,2.5627213967838,3.68819175384607,74.4720274398062,1525.05853145208,80
"324",2021-01-18,12778,1600,408,63,123,121,2,45,72,7,10,43,33,1,653,74,1021,0.0391799998283386,48,0,3.74207481990026,3.7668116686133,115.308665282628,1520.18735746223,121
"325",2021-01-19,12852,1541,415,81,111.9,74,3,24,47,8,9,45,36,7,661,50,2337,0.0410799980163574,89,0,3.95729412053699,3.35053324126313,71.3624082539418,1459.70942238648,74
"326",2021-01-20,12913,1499,415,166,111,61,1,8,50,2,7,37,30,0,663,51,3065,0.0225099992752075,163,0.00612999975681305,2.16828803404187,3.14800706710457,57.5259018873969,1455.67307704329,61
"327",2021-01-21,12984,1468,417,81,104,71,1,9,60,3,7,37,30,2,666,61,2636,0.0242799997329712,117,0,2.32481217929938,3.02433435926404,68.1095858991657,1422.50609999959,71
"328",2021-01-22,13063,1437,418,95,97,79,1,2,74,5,6,37,31,1,671,75,2311,0.0307200002670288,111,0.00901000022888184,2.97250332958338,2.94677355242072,74.0281775848231,1380.05988252521,79
"329",2021-01-23,13111,1371,418,84,92,48,1,4,40,4,9,39,30,0,675,41,2122,0.0329900002479553,276,0,2.91929860409346,2.9495703548913,43.4044823337162,1317.64744584207,48
"330",2021-01-24,13157,1287,419,44,87.7,46,2,9,35,2,8,37,29,1,677,37,1247,0.0224499988555908,36,0,2.18200690357925,2.8951825701478,44.9237898459574,1249.56533869587,46
"331",2021-01-25,13220,1228,419,29,82.9,63,1,17,43,4,7,38,31,0,681,44,825,0.0206100010871887,48,0,1.94768051511234,2.63884052660667,59.8576225100168,1196.11728277956,63
"332",2021-01-26,13282,1165,420,74,81.9,62,1,19,40,8,5,40,35,1,689,41,2354,0.024210000038147,79,0,2.3423896461076,2.40813988740247,58.7197869870371,1128.62321560727,62
"333",2021-01-27,13360,1124,422,80,69.6,78,0,27,50,1,4,30,26,2,690,50,2800,0.0196399998664856,175,0.00570999979972839,1.88205880978528,2.36724999822296,75.7455815435795,1095.80067309967,78
"334",2021-01-28,13398,1063,422,66,67.4,38,1,3,33,3,5,30,25,0,693,34,2355,0.0212299990653992,209,0.0287100005149841,2.18397183723271,2.34712994935629,36.0101595628443,1032.05292986187,38
"335",2021-01-29,13427,961,422,73,64.3,29,1,2,26,3,4,31,27,0,696,27,2847,0.0122899997234344,180,0.00555999994277954,1.18898015204223,2.09234092399327,28.5720651951927,945.768690836304,29
"336",2021-01-30,13446,864,423,42,58.3,19,1,6,12,2,5,33,28,1,698,13,2155,0.0157799994945526,216,0,1.43424288953019,1.88019010762709,18.751454846688,847.481306733725,19
"337",2021-01-31,13488,805,424,25,55.6,42,3,5,34,4,6,32,26,1,702,37,922,0.0195200002193451,24,0,1.90247782264653,1.84025738177955,41.0616592700901,784.584748984393,42
"338",2021-02-01,13528,714,424,26,55.1,40,6,6,25,4,5,29,24,0,706,31,548,0.0292000007629395,29,0,2.77324097367259,1.9581945901453,35.8539896421401,687.604793693163,40
"339",2021-02-02,13570,651,425,59,53,42,4,5,31,3,5,27,22,1,709,35,2439,0.0221399998664856,107,0.0280399990081787,2.23879574109322,1.94339546085754,38.9554679810073,631.571704446736,42
"340",2021-02-03,13633,636,425,54,49.3,63,4,22,36,2,4,26,22,0,711,40,2865,0.0129100000858307,212,0,1.20205233168362,1.84625167827158,61.3590522792987,625.808931240849,63
"341",2021-02-04,13715,638,425,51,47.1,82,3,43,33,2,5,25,20,0,713,36,2814,0.0127900004386902,90,0,1.23936161275738,1.71130736048939,78.4052426987616,627.459578939165,82
"342",2021-02-05,13773,637,427,72,47,58,1,8,48,2,5,21,16,2,715,49,2435,0.0160199999809265,149,0,1.50962461120573,1.75711371179847,56.0139378507075,624.181192059197,58
"343",2021-02-06,13798,606,427,61,49.7,25,1,4,19,3,6,21,15,0,718,20,2369,0.0143499994277954,205,0.0146300005912781,1.43722994427581,1.75754043390498,23.6168264755923,594.389842210448,25
"344",2021-02-07,13823,561,429,33,50.9,25,1,2,19,3,4,23,19,2,721,20,1004,0.0249000000953674,75,0,2.31692308579693,1.81674690006933,21.3822953744443,543.673385253164,25
"345",2021-02-08,13870,558,431,23,50.4,47,1,7,38,2,5,21,16,2,723,39,852,0.0140799999237061,29,0,1.36165266004513,1.61509142669397,45.2921028126704,547.871624858208,47
"346",2021-02-09,13925,577,431,43,48.1,55,5,8,39,0,2,18,16,0,723,44,2244,0.0178299999237061,149,0,1.67198160588368,1.5341179788069,51.0193288193791,564.139834745039,55
"347",2021-02-10,13982,594,432,41,46.3,57,0,6,50,3,4,19,15,1,726,50,2791,0.0125399994850159,100,0,1.21062395581734,1.53534249654028,55.1931022420414,584.414054635451,57
"348",2021-02-11,14042,620,433,51,46.3,60,1,11,46,1,3,16,13,1,727,47,2563,0.0152199995517731,58,0,1.48831968146488,1.57090793492707,57.0675333163289,607.699375662212,60
"349",2021-02-12,14093,623,435,52,43.4,51,0,8,41,3,2,16,14,2,730,41,2612,0.0157000005245209,173,0,1.47247401687786,1.56560070716595,48.1952319287317,610.771451014631,51
"350",2021-02-13,14126,622,435,46,41.3,33,0,3,29,6,2,21,19,0,736,29,2099,0.0219199991226196,46,0.0217400002479553,2.19161390068926,1.67336984379644,31.1527700787002,603.828378929364,33
"351",2021-02-14,14167,597,437,48,43.4,41,0,4,35,4,2,21,19,2,740,35,1175,0.0170200002193451,10,0,1.6876371525511,1.58347185333275,38.2126164035757,583.56948551242,41
"352",2021-02-15,14229,619,438,34,45,62,2,8,51,4,2,23,21,1,744,53,867,0.0265300011634827,26,0,2.57575711184093,1.75691534644643,59.1802152631132,597.746287695605,62
"353",2021-02-16,14280,614,438,61,47.6,51,2,13,32,3,2,24,22,0,747,34,1561,0.0333100008964539,23,0,3.28263329541442,1.98700844495083,45.5122137928885,587.132331436281,51
"354",2021-02-17,14337,629,439,49,48.7,57,5,6,44,2,2,25,23,1,749,49,2063,0.0184200000762939,222,0,1.66303983183345,2.0516392843817,53.9137295333129,615.055834213343,57
"355",2021-02-18,14409,645,439,68,51.1,72,3,12,53,3,3,26,23,0,752,56,2348,0.0212899994850159,116,0,2.02877105482213,2.12884662343274,66.4855312794672,627.556565629578,72
"356",2021-02-19,14463,649,440,58,52,54,2,16,33,1,3,26,23,1,753,35,2576,0.0151400005817413,96,0,1.45960484650321,2.12700817052207,50.3190071031201,636.372445997855,54
"357",2021-02-20,14511,627,440,66,54.9,48,0,3,44,4,3,26,23,0,757,44,2384,0.0255900001525879,68,0,2.48803264126303,2.16935370488975,45.5406885463664,606.204811785721,48
"358",2021-02-21,14553,616,440,53,55.6,42,0,7,33,2,4,24,20,0,759,33,1000,0.03,28,0,2.91828793774319,2.34516095991719,38.7162474452945,592.036618978831,42
"359",2021-02-22,14618,631,440,32,55.3,65,0,11,54,1,6,23,17,0,760,54,863,0.0150600004196167,66,0,1.39900757396439,2.17705388307769,63.9929452866643,619.232379183059,65
"360",2021-02-23,14673,637,440,47,53.3,55,0,7,47,3,6,25,19,0,763,47,2036,0.019650000333786,84,0,1.88714154149001,1.97769791823135,52.8176622020619,620.975549419435,55
"361",2021-02-24,14719,643,441,60,54.9,46,1,10,34,1,6,24,18,1,764,35,2874,0.0187899994850159,41,0,1.85257147581254,2.00477386737122,44.1356646841691,627.120925483449,46
"362",2021-02-25,14752,639,441,43,51.3,33,1,5,25,1,6,23,17,0,765,26,2376,0.0185199999809265,128,0.00781000018119812,1.79725239528254,1.97169977315127,30.3770952251021,623.690917263086,33
"363",2021-02-26,14817,642,441,56,51,65,5,12,43,1,6,21,15,0,766,48,2639,0.0181900000572205,181,0,1.70224858691506,2.00636316463868,58.9108104633127,627.432089946808,65
"364",2021-02-27,14864,648,442,71,51.7,47,0,5,34,3,6,23,17,1,769,34,2535,0.0209100008010864,47,0.0212800002098083,2.09167358794017,1.94974044273542,38.0519918510959,629.932079985593,47
"365",2021-02-28,14929,659,442,50,51.3,65,2,7,54,7,6,28,22,0,776,56,1552,0.0257699990272522,94,0,2.42983222905804,1.87996105578039,61.1861408667557,637.654764842714,65
"366",2021-03-01,15007,675,442,54,54.4,78,3,7,65,3,6,29,23,0,779,68,996,0.0291199994087219,45,0,2.78612098089213,2.07812011391293,72.4744956297704,649.930655148456,78
"367",2021-03-02,15071,685,443,62,56.6,64,0,6,55,3,4,29,25,1,782,55,2006,0.0259200000762939,41,0,2.54008403287961,2.17139761268287,59.1376984063142,661.805880151368,64
"368",2021-03-03,15130,695,443,65,57.3,59,0,5,51,6,5,32,27,0,788,51,2676,0.0209299993515015,109,0,2.01108360016581,2.19404220187619,54.6327764149649,676.368227615698,59
"369",2021-03-04,15188,692,443,61,59.9,58,1,3,51,1,5,31,26,0,789,52,2414,0.0202999997138977,225,0.00444000005722046,1.89477829944008,2.2079744738987,53.6865879793042,674.521516955356,58
"370",2021-03-05,15261,696,444,52,59.3,73,1,10,57,1,2,28,26,1,790,58,2440,0.0188499999046326,154,0,1.77309174122218,2.218094924514,66.6291231535806,679.549477842967,73
"371",2021-03-06,15318,710,446,46,55.7,57,1,3,48,0,2,26,24,2,790,49,1957,0.0209500002861023,25,0,2.06857470029779,2.21479508342224,50.6488407781597,690.421978622313,57
"372",2021-03-07,15358,701,447,55,56.4,40,1,0,38,2,5,25,20,1,792,39,1752,0.0194099998474121,16,0.0625,1.97999545999242,2.15053268784143,37.9706382117981,682.497881704371,40
"373",2021-03-08,15441,743,448,38,54.1,83,1,9,65,6,4,29,25,1,798,66,1170,0.0205100011825562,142,0,1.82901687374929,2.01380352967817,73.3908338489101,724.884690147579,83
"374",2021-03-09,15498,750,448,70,55.3,57,0,8,47,1,3,27,24,0,799,47,2105,0.0318300008773804,57,0,3.09908195406502,2.0936603755618,53.0583535189916,719.016279558376,57
"375",2021-03-10,15579,774,448,76,56.9,81,4,8,66,0,2,24,22,0,799,70,2655,0.0180799996852875,173,0,1.69739742448509,2.04884806475027,76.4161253067556,756.486871248984,81
"376",2021-03-11,15640,771,451,73,58.6,61,1,7,52,1,2,20,18,3,800,53,2321,0.0280100011825562,86,0,2.70092283941474,2.16401157046093,58.0917850770631,743.24087347954,61
"377",2021-03-12,15722,776,451,94,64.6,82,1,4,70,2,2,17,15,0,802,71,2361,0.0228699994087219,133,0,2.16503883736938,2.22000401276768,72.9508993977622,753.604196234697,82
"378",2021-03-13,15790,794,451,56,66,68,2,3,55,5,4,22,18,0,807,57,2353,0.0187000000476837,99,0,1.79449837325448,2.18085025176149,58.6364936476988,775.006595724085,68
"379",2021-03-14,15858,819,451,65,67.4,68,1,10,52,2,3,23,20,0,809,53,1535,0.0299699997901916,36,0,2.92832270387932,2.31632557231676,60.9311259836181,787.03004114308,68
"380",2021-03-15,15965,864,452,59,70.4,107,2,3,99,4,5,25,20,1,813,101,1000,0.0320000004768372,13,0,3.15893390689409,2.50631371990887,99.7469434806543,827.617417497875,107
"381",2021-03-16,16051,880,453,85,72.6,86,4,4,75,5,6,27,21,1,818,79,1583,0.0341100001335144,9,0,3.39171672181867,2.54811868673083,79.4282101007514,840.212973274193,86
"382",2021-03-17,16139,907,454,77,72.7,88,3,5,76,3,5,27,22,1,821,79,2842,0.0267400002479553,175,0,2.51889561500461,2.66547557109076,81.3473710652018,876.545133622001,88
"383",2021-03-18,16233,943,455,63,71.3,94,2,3,85,2,5,24,19,1,823,87,2566,0.0284500002861023,161,0,2.67703339692477,2.66206279359219,86.8953526072999,909.348477111308,94
"384",2021-03-19,16360,995,457,118,74.7,127,6,6,107,2,4,24,20,2,825,113,2615,0.0382399988174438,97,0,3.6872270246171,2.87951824891329,113.445850535841,946.093993656302,127
"385",2021-03-20,16463,1049,458,84,78.7,103,4,5,89,4,4,27,23,1,829,93,1997,0.0435699987411499,151,0.00662000000476837,4.09724895189927,3.20848261729112,92.9205751153436,991.706271999951,103
"386",2021-03-21,16547,1076,459,88,82,84,3,1,77,4,4,29,25,1,833,80,1306,0.0421099996566772,87,0,3.94800140356213,3.35415100296009,76.7897631671416,1019.37231459805,84
"387",2021-03-22,16698,1154,460,55,81.4,151,3,6,137,4,7,30,23,1,837,140,1150,0.0547800016403198,131,0,4.91779874210521,3.60541740799025,136.822211861842,1078.34880348976,151
"388",2021-03-23,16821,1190,461,109,84.9,123,2,0,119,5,9,31,22,1,842,121,1966,0.0350999999046326,153,0,3.25656440832976,3.58610993463469,115.747279609669,1138.34101434303,123
"389",2021-03-24,16978,1283,461,88,86.4,157,7,2,141,4,9,33,24,0,846,148,3106,0.0457200002670288,47,0,4.50384779033909,3.86967453111105,141.114442917162,1205.97182609945,157
"390",2021-03-25,17131,1369,462,127,95.6,153,7,4,136,8,10,40,30,1,854,143,3005,0.0379399991035461,282,0,3.46850311244771,3.98274163332861,140.388235642976,1305.70275940723,153
"391",2021-03-26,17282,1455,463,107,94,151,10,2,132,4,11,42,31,1,858,142,2390,0.0673600006103516,117,0,6.42163547900839,4.37337141252737,131.84448860661,1330.44880931421,151
"392",2021-03-27,17404,1514,465,139,101.9,122,6,3,107,5,13,44,31,2,863,113,2476,0.0626000022888184,117,0,5.97753974805686,4.64198438340702,106.995903163271,1393.36103884241,122
"393",2021-03-28,17543,1575,466,143,109.7,139,3,5,126,5,13,45,32,1,868,129,2480,0.0826599979400635,157,0,7.77386404593695,5.18853618946057,120.632016760336,1411.78625114364,139
"394",2021-03-29,17753,1724,466,114,118.1,210,7,1,190,4,12,47,35,0,872,197,1644,0.0839400005340576,40,0,8.19461762933437,5.65665317335045,176.480401673022,1535.67620550401,210
"395",2021-03-30,17965,1858,467,169,126.7,212,9,5,189,6,12,48,36,1,878,198,1968,0.0406500005722046,64,0,3.93696855935525,5.75385376635409,192.608783875296,1760.49050727425,212
"396",2021-03-31,18176,1964,468,169,138.3,211,7,5,194,8,14,54,40,1,886,201,3023,0.0793900012969971,224,0,7.3913142568778,6.16634897585962,186.195815396014,1770.49045491429,211
"397",2021-04-01,18420,2106,469,145,140.9,244,11,3,212,4,15,53,38,1,890,223,2634,0.0721299982070923,100,0.01,6.98575037591372,6.66881287064048,205.23379357522,1909.8850639884,244
"398",2021-04-02,18619,2198,470,248,161,199,14,7,164,6,15,57,42,1,896,178,3130,0.0939299964904785,99,0,9.10501359601108,7.05215260164086,163.395717781278,1931.22352631039,199
"399",2021-04-03,18873,2381,470,229,173.9,254,14,3,228,11,14,61,47,0,907,242,2885,0.101909999847412,36,0,10.0654005326869,7.63613271373086,212.529747313054,2061.53028244786,254
"400",2021-04-04,19104,2542,471,155,175.6,231,8,2,216,12,15,64,49,1,919,224,1818,0.0929599952697754,139,0,8.63573180380438,7.7592566791405,200.213855891357,2249.37331105281,231
"401",2021-04-05,19391,2687,472,186,185.9,287,6,4,272,5,17,67,50,1,924,278,2045,0.105620002746582,162,0,9.78671978326961,7.98669984398839,245.732201808857,2336.45477072086,287
"402",2021-04-06,19666,2822,473,156,184,275,6,6,248,10,19,71,52,1,934,254,1749,0.128640003204346,83,0,12.2811880788428,9.17873120391518,218.417237295196,2360.00568364977,275
"403",2021-04-07,19984,2971,474,222,191.6,318,2,7,300,12,23,77,54,1,946,302,3364,0.098100004196167,44,0,9.68334548462165,9.50616423645002,270.01732736235,2587.49827679981,318
"404",2021-04-08,20283,3144,475,175,195.9,299,23,5,259,10,29,84,55,1,956,282,3366,0.0858600044250488,194,0.0103100001811981,8.1742953631985,9.6759563774907,256.271690012858,2801.41203333485,299
"405",2021-04-09,20585,3300,477,268,198.7,302,12,2,283,14,30,89,59,2,970,295,3418,0.110299997329712,158,0,10.542656344322,9.8813339129637,255.541717446547,2836.22938160544,302
"406",2021-04-10,20872,3458,480,383,220.7,287,11,1,262,14,26,93,67,3,984,273,3187,0.0875399971008301,97,0,8.49543150914572,9.65705262388639,243.083712955159,3066.39369743201,287
"407",2021-04-11,21145,3599,480,207,228.1,273,9,3,253,13,29,101,72,0,997,262,2714,0.145909996032715,29,0,14.43673821483,10.4857678254615,214.579213757448,2906.38774928648,273
"408",2021-04-12,21461,3694,481,266,239.6,316,16,3,293,16,28,101,73,1,1013,309,2124,0.0800399971008301,107,0,7.6201234353278,10.1762540614698,280.612283110563,3318.76949453211,316
"409",2021-04-13,21700,3718,483,250,253,239,13,0,222,12,29,105,76,2,1025,235,2668,0.0768400001525879,179,0,7.20088234657901,9.45049609971782,212.442403789852,3361.11003102413,239
"410",2021-04-14,21972,3785,485,394,277.6,272,12,9,248,13,29,103,74,2,1038,260,3873,0.150530004501343,96,0,14.6889067128672,10.1655762751815,218.090121379214,3043.86965161664,272
"411",2021-04-15,22200,3787,485,323,298.7,228,14,3,209,19,30,109,79,0,1057,223,3847,0.118269996643066,97,0,11.5361226441652,10.6458373153196,191.707119310146,3204.63614720862,228
"412",2021-04-16,22438,3829,487,355,311.1,238,4,10,218,20,25,116,91,2,1077,222,2959,0.117609996795654,243,0,10.8684566058195,10.6923802098192,199.836737806556,3274.25616694281,238
"413",2021-04-17,22619,3770,490,402,313.9,181,5,7,168,16,24,125,101,3,1093,173,2925,0.0988000011444092,121,0.00825999975204468,9.52033694410355,10.8387952719561,158.044786571339,3291.55401950259,181
"414",2021-04-18,22779,3707,490,295,326.4,160,3,6,147,10,22,122,100,0,1103,150,1938,0.0598600006103516,188,0.0159599995613098,5.59779685326376,9.57608936316087,144.806970879681,3430.38294033985,160
"415",2021-04-19,23006,3642,491,255,324.9,227,3,5,219,22,22,116,94,1,1125,222,2058,0.101549997329712,90,0.0555600023269653,9.96230422318315,9.91068661856878,197.518334442305,3158.34132449944,227
"416",2021-04-20,23199,3533,492,190,316.3,193,3,2,185,17,28,120,92,1,1142,188,2750,0.0941800022125244,221,0,8.71743541179543,10.1273370564568,168.153300827003,3122.44474373298,193
"417",2021-04-21,23395,3424,493,206,289.4,196,2,3,184,11,26,111,85,1,1153,186,2427,0.10423999786377,232,0.00430999994277954,9.55210209861202,9.39350782584895,165.316213307967,2988.01459336817,196
"418",2021-04-22,23569,3311,496,238,277.3,174,2,4,164,14,23,107,84,3,1167,166,2307,0.145209999084473,212,0,13.2989070221468,9.64533416556061,140.571828477168,2724.03207281869,174
"419",2021-04-23,23776,3227,499,188,253.4,207,3,6,190,21,30,113,83,3,1188,193,2487,0.0755900001525879,86,0.0116299998760223,7.34521999101531,9.14201464916001,180.102630388259,2911.03206353841,207
"420",2021-04-24,23931,3102,500,228,228.6,155,2,3,148,18,32,119,87,1,1206,150,2421,0.0689799976348877,214,0.00467000007629395,6.37570984024251,8.69278220575129,140.251501300386,2838.36104689197,155
"421",2021-04-25,24076,2965,505,139,206.3,145,1,5,137,21,31,125,94,5,1227,138,1595,0.122880001068115,92,0.0217400002479553,11.7364363797543,9.56973070953565,121.409903860032,2501.12583293475,145
"422",2021-04-26,24234,2820,509,172,194.4,158,2,6,146,11,32,123,91,4,1238,148,1268,0.0906900024414063,31,0,8.85257298658223,9.41119767573552,136.534924299397,2487.21950354256,159
"423",2021-04-27,24389,2716,510,189,194.3,155,1,4,146,10,32,120,88,1,1248,147,2414,0.0580000019073486,328,0.00610000014305115,5.17916865978338,8.90573099687666,140.851154765948,2528.48800234227,157
"424",2021-04-28,24552,2607,511,186,191.4,163,0,7,154,13,29,116,87,1,1261,154,2362,0.0516499996185303,38,0,5.08322079579035,8.26731938218785,150.564844238909,2430.3477203301,165
"425",2021-04-29,24675,2500,511,159,180.1,123,1,5,112,13,31,114,83,0,1274,113,2711,0.0597599983215332,111,0.00901000022888184,5.77638077516238,7.19267277547579,109.298913255693,2307.49808087817,124
"426",2021-04-30,24818,2397,514,178,178.7,143,3,3,130,13,29,111,82,3,1287,133,2114,0.0638600015640259,179,0,5.88748553451159,6.98442499597525,125.56191726237,2208.87906524738,147
"427",2021-05-01,24932,2333,517,137,165.7,114,1,4,106,7,31,112,81,3,1294,107,2011,0.0730999994277954,70,0.0285700011253357,7.1602113852989,7.09649664526902,100.787105104714,2110.32071223642,118
"428",2021-05-02,25012,2253,517,129,164.3,80,0,1,77,8,29,110,81,0,1302,77,1270,0.0653499984741211,21,0,6.4286985330855,6.33824838145919,71.4013814047383,2059.92613382955,77
"429",2021-05-03,25110,2129,520,103,154.4,98,1,4,92,10,24,101,77,3,1312,93,932,0.135190000534058,139,0,11.7644332864371,6.75422842429561,82.415444389507,1795.12345274474,112
"430",2021-05-04,25201,2018,520,141,147.6,91,0,0,89,9,25,98,73,0,1321,89,2384,0.0390100002288818,56,0,3.8114688748219,6.55884274072968,84.4780930104486,1915.4695696077,115
"431",2021-05-05,25273,1890,521,114,137.3,72,2,3,65,8,24,91,67,1,1329,67,1868,0.061560001373291,64,0.0156299996376038,6.00385106325643,6.69036135036769,64.637788325627,1738.73761097664,101
"432",2021-05-06,25338,1778,522,123,132.1,65,1,5,57,12,22,90,68,1,1341,58,2103,0.0408900022506714,246,0,3.66077797927467,6.38813237952659,60.169646863162,1691.23503659831,108
"433",2021-05-07,25406,1638,524,109,122.3,68,1,1,64,15,21,92,71,2,1356,65,2292,0.0536600017547607,81,0,5.18283708478346,6.28746831527971,61.5092367993171,1524.83276734279,114
"434",2021-05-08,25446,1518,525,138,122.4,40,0,1,39,2,20,81,61,1,1358,39,1832,0.0513100004196167,85,0,4.90349091125393,5.96507967613043,37.4507688149651,1418.77607849018,99
"435",2021-05-09,25446,1380,525,51,111.3,0,0,0,0,0,20,79,59,0,1358,0,1076,0.154280004501343,123,0.00813000023365021,13.9287135005991,7.03651038577524,0,1123.77037982095,104
