"","date","observed_cumulative_cases","observed_active_cases","observed_cumulative_deaths","observed_new_cases","observed_daily_average_cases","observed_new_episodes","observed_new_cases_community_outbreak","observed_new_cases_institution_outbreak","observed_new_cases_sporadic","observed_new_ICU_p_acute_care","observed_census_ICU","observed_census_ICU_p_acute_care","observed_census_acute_care","observed_new_deaths","cumulative_hosp","observed_new_community_cases","num_non_ltch_tests","non_ltch_pct_positivity","num_ltch_tests","ltch_pct_positivity","observed_pct_positivity","pct_positivity_7_day","adjusted_new_episodes","adjusted_active_cases","adjusted_episode_cases"
"1",2020-03-01,7,7,0,0,0,2,0,0,2,0,0,2,2,0,0,2,NA,NA,NA,NA,NA,NA,NA,NA,2
"2",2020-03-02,10,10,0,0,0,3,2,0,1,0,0,2,2,0,0,3,NA,NA,NA,NA,NA,NA,NA,NA,3
"3",2020-03-03,11,11,0,0,0,1,0,0,1,0,0,2,2,0,0,1,NA,NA,NA,NA,NA,NA,NA,NA,1
"4",2020-03-04,12,12,0,0,0,1,0,0,1,0,0,2,2,0,0,1,NA,NA,NA,NA,NA,NA,NA,NA,1
"5",2020-03-05,18,17,0,0,0,6,2,0,4,0,0,2,2,0,0,6,NA,NA,NA,NA,NA,NA,NA,NA,6
"6",2020-03-06,23,22,0,0,0,5,0,1,4,0,0,2,2,0,0,4,NA,NA,NA,NA,NA,NA,NA,NA,5
"7",2020-03-07,27,26,0,0,0,4,0,0,4,0,0,2,2,0,0,4,NA,NA,NA,NA,NA,NA,NA,NA,4
"8",2020-03-08,36,35,0,0,0,9,1,0,8,0,0,2,2,0,0,9,NA,NA,NA,NA,NA,NA,NA,NA,9
"9",2020-03-09,45,44,0,1,0.1,9,0,0,9,0,0,2,2,0,0,9,NA,NA,NA,NA,NA,NA,NA,NA,9
"10",2020-03-10,52,51,0,0,0.1,7,1,0,6,0,0,2,2,0,0,7,NA,NA,NA,NA,NA,NA,NA,NA,7
"11",2020-03-11,61,60,0,0,0.1,9,0,0,9,0,0,2,2,0,0,9,NA,NA,NA,NA,NA,NA,NA,NA,9
"12",2020-03-12,75,74,0,3,0.6,14,1,0,13,0,0,2,2,0,0,14,NA,NA,NA,NA,NA,NA,NA,NA,14
"13",2020-03-13,97,96,0,1,0.7,22,2,2,18,0,0,2,2,0,0,20,NA,NA,NA,NA,NA,NA,NA,NA,22
"14",2020-03-14,115,114,0,4,1.3,18,1,1,16,1,0,3,3,0,1,17,NA,NA,NA,NA,NA,NA,NA,NA,18
"15",2020-03-15,142,140,0,4,1.9,27,1,0,26,0,0,3,3,0,1,27,NA,NA,NA,NA,NA,NA,NA,NA,27
"16",2020-03-16,157,155,0,0,1.7,15,0,0,15,0,0,3,3,0,1,15,NA,NA,NA,NA,NA,NA,NA,NA,15
"17",2020-03-17,180,177,0,5,2.4,23,1,0,22,2,0,5,5,0,3,23,127,0,4,0,0,0.0682277220955398,23,177,23
"18",2020-03-18,196,192,0,4,3,16,0,0,16,0,0,4,4,0,3,16,210,0.0190499997138977,1,0,1.89597153550641,1.86766928113351,15.4620401996089,185.544482395307,16
"19",2020-03-19,221,217,0,1,2.7,25,0,0,25,4,0,8,8,0,7,25,110,0.0272699999809265,9,0,2.52075630075791,2.55818309876165,23.8824450197804,207.299622771694,25
"20",2020-03-20,243,239,0,2,2.9,22,1,1,20,3,1,11,10,0,10,21,137,0.00730000019073486,4,0,0.709290798674238,0.745246482243557,21.7358554533951,235.993783493401,22
"21",2020-03-21,263,259,0,4,2.9,20,0,2,18,3,1,11,10,0,13,18,204,0.0147099995613098,3,0,1.44968111618705,1.48320006593073,19.5372536359586,252.341593984072,20
"22",2020-03-22,289,284,0,7,3.3,26,0,1,25,3,5,14,9,0,16,25,159,0.0314499998092651,2,0,3.10593165818208,3.04595026981846,24.6230127078213,268.35742436085,26
"23",2020-03-23,310,305,0,9,4.6,21,2,0,19,4,5,18,13,0,20,21,138,0.0362299990653992,3,0,3.54591480214545,3.83936858140591,19.6794780653253,285.820990948772,21
"24",2020-03-24,328,321,1,8,5,18,1,3,14,3,7,21,14,1,23,15,253,0.0197599995136261,4,0,1.94524508830638,1.92107114305147,17.4825556911953,309.92669179158,18
"25",2020-03-25,351,344,1,8,5.6,23,0,1,22,4,8,24,16,0,27,22,153,0.0588199996948242,2,0,5.80610319568265,6.17393298424554,20.7348057028573,308.580598262859,23
"26",2020-03-26,365,354,1,19,8.1,14,1,3,10,2,7,26,19,0,29,11,274,0.025550000667572,3,0,2.5273285858898,2.49473764973619,13.5069937523656,338.134162576129,14
"27",2020-03-27,382,362,1,27,11.7,17,3,2,12,5,9,27,18,0,34,15,577,0.0294600009918213,4,0,2.92571782655437,2.84760474709219,16.2217453483782,343.218121074194,17
"28",2020-03-28,407,384,2,26,14.9,25,1,1,23,3,8,26,18,1,37,24,367,0.0817399978637695,3,0,8.10772411243336,9.26847180501087,21.5492918299651,328.788669279442,25
"29",2020-03-29,426,396,2,11,15.4,19,5,4,10,7,8,32,24,0,44,15,184,0.0434800004959106,0,0,4.34800004959107,4.78850575942822,17.8434116123115,365.466066565024,19
"30",2020-03-30,451,406,3,48,21,25,8,3,14,4,12,33,21,1,48,22,549,0.0783199977874756,0,0,7.83199977874756,9.05392896877619,21.9444219924934,349.610696770559,25
"31",2020-03-31,468,403,3,51,27.1,17,2,3,12,6,13,35,22,0,54,14,943,0.064689998626709,0,0,6.4689998626709,7.07081840955355,15.3939346749305,356.768262428356,17
"32",2020-04-01,495,405,3,37,31.3,27,6,4,16,3,15,34,19,0,57,22,575,0.0573899984359741,4,0.25,5.87206374795943,5.83661537234577,23.7090718394005,362.826095225327,27
"33",2020-04-02,512,401,6,32,33.1,17,5,4,7,6,14,35,21,3,63,12,107,0.0841100025177002,9,0,7.75842264602924,10.6833631714187,14.3489785764798,345.828367430702,17
"34",2020-04-03,539,406,6,26,33,27,3,4,19,5,14,38,24,0,68,22,217,0.110600004196167,2,0,10.9589958495745,11.2302743377711,21.7244551010864,327.096762320049,27
"35",2020-04-04,556,414,7,18,31.9,17,3,7,6,7,14,44,30,1,75,9,315,0.0253999996185303,3,0,2.51603769806196,2.51880427570877,15.5984333093779,395.527932231384,17
"36",2020-04-05,583,425,8,40,36,27,4,8,13,4,13,44,31,1,79,17,422,0.0663500022888184,5,0.2,6.79149905524153,7.16625550762299,22.9525533502622,373.813833756555,27
"37",2020-04-06,602,425,9,40,34.9,19,3,7,9,4,12,45,33,1,83,12,238,0.117650003433228,4,0.25,11.9837606682265,11.9837606682265,16.4498108055886,334.680799364598,19
"38",2020-04-07,625,423,9,25,31.1,23,2,11,10,4,14,46,32,0,87,12,285,0.108769998550415,6,0,10.6527318167932,11.0858887075266,20.733058734878,343.090320404451,23
"39",2020-04-08,645,426,11,26,29.6,20,1,10,8,5,16,45,29,2,92,9,368,0.0434800004959106,6,0.333330001831055,4.81300005173301,4.77752109217152,18.2318316596659,389.640031890851,20
"40",2020-04-09,681,434,11,25,28.6,36,1,20,13,6,16,48,32,0,98,14,295,0.0949199962615967,5,0,9.33379963239034,10.8422596364194,31.6826878560886,362.163323538745,36
"41",2020-04-10,715,450,11,36,30,34,0,20,13,4,16,50,34,0,102,13,331,0.090629997253418,8,0,8.84912362562872,10.5709820835789,30.9599460958516,379.382749471785,34
"42",2020-04-11,759,480,11,31,31.9,44,0,34,8,5,19,54,35,0,107,8,225,0.102220001220703,11,0.363639984130859,11.4404830932617,11.1568075846736,40.3769482067714,382.616892406281,44
"43",2020-04-12,792,495,13,35,31.1,33,0,18,14,1,18,50,32,2,108,14,227,0.101319999694824,12,0.5,12.1337405567887,11.3196297466928,28.9875436102418,388.488149076405,33
"44",2020-04-13,816,502,16,16,27.7,24,0,19,5,3,20,52,32,3,111,5,165,0.0606099987030029,26,0.0384599995613098,5.75948155737672,6.42098049601253,23.489316972371,450.727424026053,24
"45",2020-04-14,849,502,18,32,28.7,33,0,26,7,5,20,51,31,2,116,7,208,0.0673099994659424,18,0.166669998168945,7.52236276812258,7.25808967544895,32.0662075853339,435.033743976806,33
"46",2020-04-15,878,500,24,60,33.6,29,2,18,9,4,16,51,35,6,120,11,390,0.1,24,0.208330001831055,10.6280000106148,11.2208254986817,26.9267949429508,405.763406497765,29
"47",2020-04-16,948,549,24,21,33,70,1,55,13,7,13,53,40,0,127,14,310,0.0354800009727478,11,0,3.42641753942424,3.44256196095498,68.1493197532691,515.641181753194,70
"48",2020-04-17,980,553,26,73,38.3,32,0,26,6,0,13,50,37,2,127,6,378,0.0846599960327148,66,0.5,14.6399726352176,11.0968359100993,30.4422794707592,409.430091221639,32
"49",2020-04-18,1020,575,31,31,38.3,40,0,31,9,1,11,47,36,5,128,9,421,0.0617600011825562,8,0,6.06082995288022,6.90992439319942,39.032674499084,513.198648552588,40
"50",2020-04-19,1037,578,35,38,38.7,17,0,13,4,5,15,48,33,4,133,4,452,0.0442500019073486,47,0.127659997940063,5.21062540386865,4.88696098109646,16.6303864602286,524.590843503026,17
"51",2020-04-20,1098,614,39,16,38.7,61,1,47,13,3,13,46,33,4,136,14,325,0.0523099994659424,43,0.0232599997520447,4.89155701515467,5.30796909845401,59.7855680515663,560.738484547267,61
"52",2020-04-21,1134,627,47,51,41.4,36,0,26,10,2,11,44,33,8,138,10,543,0.069980001449585,25,0.36,8.27449661745152,7.30232353410966,34.5326300839375,534.995906262882,36
"53",2020-04-22,1175,644,54,35,37.9,41,1,31,9,4,9,46,37,7,142,10,656,0.0243899989128113,122,0.106560001373291,3.7275269221524,2.66641605080181,40.3389735811429,601.429898625601,41
"54",2020-04-23,1220,659,57,50,42,45,0,35,10,5,11,49,38,3,147,10,775,0.0361299991607666,105,0.0285700011253357,3.522795394063,3.79950185760028,44.3752799450314,617.830948377571,45
"55",2020-04-24,1261,666,65,38,37,41,0,36,5,7,10,49,39,8,154,5,517,0.0406199979782104,94,0.106379995346069,5.07369206501887,4.27172068302449,40.5501247118845,606.076611623014,41
"56",2020-04-25,1362,738,78,53,40.1,101,0,95,6,4,9,49,40,13,158,6,557,0.0502699995040894,28,0.0357100009918213,4.95731106864081,4.84635588921963,100.472532810418,673.121535681424,101
"57",2020-04-26,1416,757,87,88,47.3,54,0,41,13,5,9,51,42,9,163,13,358,0.0502799987792969,81,0.0123500001430511,4.32815252268233,4.83696245300733,53.0021989944772,698.897279909172,54
"58",2020-04-27,1477,781,95,87,57.4,61,0,54,7,8,11,57,46,8,171,7,269,0.0632000017166138,80,0.1,7.16355314090805,6.98245624341149,60.1107486050282,681.784951503858,61
"59",2020-04-28,1498,777,103,65,59.4,21,0,14,7,7,13,62,49,8,178,7,503,0.0616300010681152,11,0.272730007171631,6.61477054788909,6.67282066897622,20.1788720176391,685.85479395794,21
"60",2020-04-29,1523,766,111,29,58.6,25,0,17,8,7,13,63,50,8,185,8,668,0.0314400005340576,74,0.148649997711182,4.31294072606172,3.21249666582698,24.3881266968834,707.413131226588,25
"61",2020-04-30,1543,756,122,30,55.7,20,0,10,10,2,11,57,46,11,187,10,603,0.0414599990844727,6,0.333330001831055,4.43355656139956,4.45247146302617,19.2137687861714,696.560920234561,20
"62",2020-05-01,1566,740,135,42,56.3,23,0,16,7,6,11,58,47,13,193,7,516,0.031010000705719,55,0.0909099960327148,3.67797025323123,3.28223071234903,22.5434332496714,691.734372108118,23
"63",2020-05-02,1587,741,139,22,51.9,21,0,15,6,4,12,58,46,4,197,6,508,0.0511800003051758,28,0.0357100009918213,5.03718660126871,4.9878354797488,20.4640339040295,674.808187147639,21
"64",2020-05-03,1606,722,148,23,42.6,19,0,13,6,3,12,53,41,9,200,6,826,0.0205800008773804,231,0.0043299999833107,1.70286761786764,1.95645882555284,18.81881169364,700.19700713468,19
"65",2020-05-04,1624,719,152,14,32.1,18,0,11,7,6,10,53,43,4,206,7,637,0.0109899997711182,24,0.125,1.51295459216373,1.19324615954435,17.8121885948011,699.709085666003,18
"66",2020-05-05,1649,719,156,29,27,25,0,24,1,3,9,51,42,4,209,1,923,0.0292499995231628,29,0.172409992218018,3.36109656871868,2.91888542363166,24.9403955041867,676.144367510254,25
"67",2020-05-06,1665,693,161,23,26.1,16,0,11,5,4,10,53,43,5,213,5,598,0.0167200005054474,149,0.0134200000762939,1.60617674881196,1.70324857958964,15.8575831527857,673.261024976098,16
"68",2020-05-07,1688,671,167,32,26.4,23,0,16,7,6,10,55,45,6,219,7,813,0.0356699991226196,234,0.0128199994564056,3.05631224063884,3.47788027775648,22.6206030903942,634.632096236357,23
"69",2020-05-08,1701,638,173,16,22.7,13,0,8,5,4,8,55,47,6,223,5,715,0.00978999972343445,127,0.0472399997711182,1.54386339349022,1.14504484655955,12.8631083676232,620.532627708727,13
"70",2020-05-09,1718,622,179,12,21.3,17,0,12,5,5,7,53,46,6,228,5,1100,0.0154499995708466,164,0.0304900002479553,1.74013920637626,1.57628973726356,16.845704938968,602.80569440762,17
"71",2020-05-10,1730,553,185,25,21.6,12,0,8,4,3,6,54,48,6,231,4,907,0.0176400005817413,316,0.0126600003242493,1.6353262984548,1.67570763667755,11.8839988110824,536.962835632136,12
"72",2020-05-11,1750,534,188,14,21.6,20,0,14,6,1,6,53,47,3,232,6,517,0.00967000007629394,197,0.0152300000190735,1.12040616851561,1.0889665003241,19.8807866836044,523.390014840794,20
"73",2020-05-12,1773,517,193,13,19.3,23,0,17,6,4,7,53,46,5,236,6,835,0.0131700003147125,322,0.00310999989509583,1.03702422031165,1.31731084051898,22.8896586791827,507.492256189574,23
"74",2020-05-13,1794,499,195,21,19,21,0,15,6,2,8,49,41,2,238,6,1249,0.0144099998474121,224,0.0133899998664856,1.42548878340193,1.4381114240886,20.8483253215401,486.385722574756,21
"75",2020-05-14,1808,471,198,25,18,14,0,10,4,2,7,47,40,3,240,4,1046,0.0267700004577637,127,0.0236199998855591,2.6428951802461,2.60168265296136,13.8125273326902,448.925093424266,14
"76",2020-05-15,1828,457,201,17,18.1,20,0,12,8,1,6,46,40,3,241,8,1163,0.012039999961853,137,0.0146000003814697,1.23097846214588,1.19819432965585,19.8253621124104,447.023810671444,20
"77",2020-05-16,1844,437,207,19,19.1,16,0,6,10,1,5,44,39,6,242,10,967,0.0134399998188019,25,0.04,1.4109354662078,1.41249248485223,15.7497897029467,426.065810018772,16
"78",2020-05-17,1856,397,212,15,17.7,12,0,9,3,1,3,44,41,5,243,3,353,0.0254999995231628,10,0.1,2.7552341134095,2.522239466397,11.8534189629905,377.602442769073,12
"79",2020-05-18,1871,389,213,26,19.4,15,0,8,7,2,2,45,43,1,245,7,376,0.0398900008201599,17,0.0588199996948242,4.07088557333133,4.19857708911144,14.4946585020521,360.917451042612,15
"80",2020-05-19,1883,352,219,23,20.9,12,0,8,4,0,2,42,40,6,245,4,359,0.0390000009536743,31,0.225809993743896,5.38490003805894,4.06473651438651,11.6180243617389,318.386143833021,12
"81",2020-05-20,1898,338,223,17,20.3,15,0,9,6,3,2,43,41,4,248,6,675,0.0296300005912781,36,0.0555600023269653,3.0942912071566,2.9418364842439,14.6707616156848,319.452904350246,15
"82",2020-05-21,1906,324,229,11,18.3,8,0,1,7,0,2,40,38,6,248,7,478,0.0209200000762939,36,0,1.94547860631683,2.07637640864042,7.75849700134481,312.821861205103,8
"83",2020-05-22,1913,308,233,7,16.9,7,0,3,4,1,2,38,36,4,249,4,514,0.00583999991416931,14,0,0.568515143159664,0.63341341295356,6.95967261543674,304.894791388629,7
"84",2020-05-23,1922,304,236,6,15,9,1,3,5,1,1,37,36,3,250,6,582,0.00859000027179718,43,0,0.799900825309753,0.877191496105654,8.91488905286993,299.687712012076,9
"85",2020-05-24,1931,300,237,8,14,9,0,3,6,1,2,38,36,1,251,6,332,0.0150600004196167,25,0.04,1.68064989896716,1.59087347464804,8.82117570057543,291.058785028772,9
"86",2020-05-25,1946,296,240,6,11.1,15,1,7,7,0,2,37,35,3,251,8,401,0.0174600005149841,8,0,1.71184846124906,1.68599092729523,14.757141486761,287.014235010155,15
"87",2020-05-26,1952,286,243,16,10.1,6,0,2,4,1,2,37,35,3,252,4,1123,0.00800999999046326,41,0.0731699991226196,1.03051545990701,0.892886536171215,5.92690081565974,280.773408319671,6
"88",2020-05-27,1957,258,243,8,8.9,5,0,1,4,1,2,35,33,0,253,4,1150,0.00957000017166138,13,0.0769199991226196,1.03228376491871,1.07305846394025,4.92677538168126,253.277012118441,5
"89",2020-05-28,1961,233,244,4,7.9,4,0,2,2,1,1,32,31,1,254,2,1403,0.00284999996423721,88,0,0.268179071081476,0.294405749467932,3.99048841472259,231.891900315182,4
"90",2020-05-29,1968,223,247,7,7.9,7,0,3,4,2,1,33,32,3,256,4,1380,0.0065200001001358,37,0,0.634975309681539,0.698374502119094,6.95495829124377,220.48892473684,7
"91",2020-05-30,1971,205,248,15,9.1,3,1,1,1,0,1,32,31,1,256,2,1020,0.0127499997615814,119,0,1.1417910234252,1.24632879607974,2.95950376498624,200.84913591109,3
"92",2020-05-31,1975,190,249,10,9.4,4,0,1,3,3,1,35,34,1,259,3,1309,0.00535000026226044,11,0.0909099960327148,0.606300022701422,0.597603238669766,3.96774427057434,187.957137136375,4
"93",2020-06-01,1986,180,250,5,9.3,11,0,5,6,0,1,32,31,1,259,6,763,0.00130999997258186,20,0,0.127653892602805,0.169335525038837,10.9864173865553,179.59252159666,11
"94",2020-06-02,1989,161,251,8,8.1,3,0,1,2,0,1,27,26,1,259,2,858,0.0104900002479553,9,0,1.03811075118174,1.18266175492427,2.96318102342051,158.036072385351,3
"95",2020-06-03,1999,152,251,8,8.1,10,0,7,3,0,0,23,23,0,259,3,1110,0.00449999988079071,141,0,0.399280564962245,0.476225090951365,9.9787578997425,150.923733586954,10
"96",2020-06-04,2006,142,254,8,8.7,7,0,2,5,0,0,21,21,3,259,5,1430,0.00559000015258789,21,0,0.550909732474203,0.600132217670772,6.95115180987604,140.61271140048,7
"97",2020-06-05,2010,133,256,15,9.9,4,0,1,3,1,0,22,22,2,260,3,1366,0.00952000021934509,29,0,0.932209340474939,1.06050425079729,3.95040558943004,130.801314464732,4
"98",2020-06-06,2013,124,257,2,8,3,0,0,3,0,0,22,22,1,260,3,1404,0.000710000023245811,68,0,0.0677201109128478,0.111608715372448,2.99639722663287,123.851085367492,3
"99",2020-06-07,2014,116,258,4,7.1,1,0,0,1,0,0,21,21,1,260,1,870,0.00230000004172325,22,0,0.22432735832951,0.260635793652727,0.996021858099884,115.538535539587,1
"100",2020-06-08,2017,108,258,0,6.4,3,0,0,3,0,0,20,20,0,260,3,701,0.0014300000667572,12,0,0.140593274445554,0.181145338161369,2.99252030603697,107.730731017331,3
"101",2020-06-09,2027,105,259,3,5.7,10,0,3,7,0,0,19,19,1,260,7,1338,0.00224000006914139,10,0,0.222338285794598,0.238433440958048,9.97239992125284,104.585998818793,10
"102",2020-06-10,2037,103,259,7,5.6,10,0,4,6,0,0,18,18,0,260,6,1281,0.00233999997377396,12,0,0.231828303666236,0.27570672584388,9.97533303395587,102.576550416242,10
"103",2020-06-11,2044,102,260,5,5.1,7,0,2,5,0,0,17,17,1,260,5,1529,0.00326999992132187,6,0,0.325721816267175,0.349359466352886,6.97111882351927,101.410823999793,7
"104",2020-06-12,2048,105,260,10,4.4,4,0,2,2,0,0,17,17,0,260,2,1596,0.00814999997615814,13,0,0.808415162333648,0.877774946875169,3.97132770381717,103.494704450401,4
"105",2020-06-13,2051,103,260,6,5,3,0,3,0,0,0,17,17,0,260,0,1479,0.00270000010728836,23,0.0434800004959106,0.332446083228058,0.294042051336318,3,102.392765450385,3
"106",2020-06-14,2054,100,260,1,4.6,3,0,1,2,0,0,17,17,0,260,2,768,0,13,0,0,0.0521610981281388,3,100,3
"107",2020-06-15,2059,98,260,2,4.9,5,0,2,3,0,0,15,15,0,260,3,720,0.00555999994277954,17,0,0.543175028331244,0.592271141856151,4.97110257943491,97.0560175948738,5
"108",2020-06-16,2063,97,260,3,4.9,4,0,1,3,1,0,15,15,0,261,3,1250,0.000799999982118607,14,0,0.0791139222822989,0.124292396218897,3.99579106518985,96.8639111078053,4
"109",2020-06-17,2066,87,260,8,5,3,0,0,3,1,1,7,6,0,262,3,1098,0.0091100001335144,26,0,0.889927059305944,0.965196058382613,2.95265504641474,85.6269963460274,3
"110",2020-06-18,2068,73,260,2,4.6,2,0,0,2,0,1,7,6,0,262,2,1304,0.00230000004172325,122,0,0.210322584460527,0.254163126305685,1.99254042759641,72.7277256072688,2
"111",2020-06-19,2071,71,260,5,3.9,3,0,0,3,0,1,6,5,0,262,3,1875,0.0010700000077486,19,0,0.105926611115556,0.140817668846419,2.99436460501536,70.8666289853635,3
"112",2020-06-20,2077,71,261,1,3.1,6,0,0,6,1,1,6,5,1,263,6,1792,0.000560000017285347,158,0,0.0514625656910432,0.0864639924673691,5.99452428655013,70.9352040575099,6
"113",2020-06-21,2083,75,261,1,3.1,6,0,0,6,0,1,5,4,0,263,6,1102,0.00363000005483627,86,0,0.336722227308887,0.386847632565,5.96417212386935,74.5521515483668,6
"114",2020-06-22,2085,74,262,6,3.7,2,0,1,1,0,1,2,1,1,263,1,509,0.0039300000667572,10,0,0.385427752211834,0.413040803603067,1.99316496078785,73.4942070983005,2
"115",2020-06-23,2094,79,262,4,3.9,9,0,0,9,0,1,2,1,0,263,9,1255,0.00158999994397163,20,0,0.156505876837992,0.20511327517193,8.97502122202972,78.7807418378164,9
"116",2020-06-24,2096,73,263,3,3.1,2,0,0,2,1,1,3,2,1,264,2,1733,0.00289000004529953,24,0,0.285052366448724,0.302626141637317,1.98988996463792,72.630983709284,2
"117",2020-06-25,2102,71,263,6,3.7,6,0,0,6,0,1,3,2,0,264,6,1796,0.00277999997138977,21,0.0476200008392334,0.32982388366758,0.297495912613915,5.96490612056289,70.5847224266609,6
"118",2020-06-26,2106,65,263,6,3.9,4,0,0,4,0,1,3,2,0,264,4,2028,0.00196999996900558,23,0,0.194790830674955,0.21897496087661,3.98618259366959,64.7754671471309,4
"119",2020-06-27,2109,67,263,3,4.1,3,0,0,3,0,1,2,1,0,264,3,1574,0.000640000030398369,80,0,0.0609044768952257,0.0991969508608706,2.99675982475015,66.9276360860866,3
"120",2020-06-28,2111,66,263,2,4.3,2,0,0,2,0,1,2,1,0,264,2,880,0.00114000000059605,12,0,0.112466367771807,0.153639536749867,1.99601112255484,65.8683670443096,2
"121",2020-06-29,2115,67,263,1,3.6,4,0,0,4,2,1,4,3,0,266,4,854,0.00351000010967255,8,0,0.347742470262222,0.363503469357179,3.97533303290867,66.5868283012202,4
"122",2020-06-30,2118,66,263,10,4.4,3,0,0,3,0,1,4,3,0,266,3,1605,0.00435999989509583,11,0,0.433032167798812,0.452564866762987,2.97696228283996,65.493170222479,3
"123",2020-07-01,2120,65,263,4,4.6,2,0,0,2,0,2,4,2,0,266,2,1601,0.00312000006437302,15,0,0.309103966773589,0.328597072417982,1.98903691951913,64.6436998843716,2
"124",2020-07-02,2126,64,263,4,4.3,6,0,1,5,0,1,4,3,0,266,5,1012,0.00197999998927116,12,0,0.195679686439689,0.228139285476849,5.98264942882081,63.7779126889063,6
"125",2020-07-03,2134,72,263,4,4,8,0,0,8,0,1,4,3,0,266,8,1334,0.00300000011920929,14,0,0.296884284794154,0.317636273757058,7.95788127416574,71.6209314674917,8
"126",2020-07-04,2137,72,263,4,4.1,3,0,0,3,0,1,4,3,0,266,3,1257,0.00317999988794327,40,0,0.308192741645697,0.338155975739293,2.98360385730949,71.6064925754277,3
"127",2020-07-05,2139,69,263,5,4.6,2,0,0,2,0,1,3,2,0,266,2,734,0.00272000014781952,47,0,0.255631255889824,0.289856953916234,1.99093345174118,68.6872040850706,2
"128",2020-07-06,2145,69,263,0,4.4,6,0,1,5,0,1,3,2,0,266,5,602,0,10,0,0,0.0370287251116308,6,69,6
"129",2020-07-07,2152,70,263,6,3.9,7,0,1,6,0,1,2,1,0,266,6,1272,0.0039300000667572,21,0,0.386617175940848,0.401267808762771,6.95886320781287,69.5200707578169,7
"130",2020-07-08,2165,76,263,5,4,13,0,1,12,0,1,2,1,0,266,12,1684,0.00296999990940094,39,0,0.29027741424441,0.309426980040228,12.9382278780692,75.6087765611046,13
"131",2020-07-09,2173,80,263,5,4.1,8,0,0,8,1,0,3,3,0,267,8,1504,0.00266000002622604,41,0,0.258941102876632,0.28540179114291,7.96326424173363,79.6326424173363,8
"132",2020-07-10,2189,93,263,12,5.3,16,0,0,16,0,0,3,3,0,267,16,1900,0.00684000015258789,14,0.0714300012588501,0.73124453017455,0.724052829099123,15.7925178969606,91.7940102760834,16
"133",2020-07-11,2196,98,263,7,5.7,7,0,0,7,1,1,3,2,0,268,7,1571,0.00381999999284744,25,0,0.376016290022765,0.397944340914273,6.95332302226874,97.3465223117623,7
"134",2020-07-12,2219,118,263,9,6.3,23,0,2,21,1,1,4,3,0,269,21,1068,0.00842999994754791,13,0,0.832862159480219,0.889419503585497,22.6898366679626,116.257177467599,23
"135",2020-07-13,2242,136,263,6,7.1,23,0,2,21,0,0,4,4,0,269,21,808,0.00619000017642975,65,0,0.572911814725686,0.666457204960571,22.7866438817081,134.618265138681,23
"136",2020-07-14,2261,146,263,4,6.9,19,0,2,17,1,0,5,5,0,270,17,1406,0.00356000006198883,66,0,0.340038049399205,0.373562758507914,18.8974880568542,145.119603311807,19
"137",2020-07-15,2282,166,263,15,8.3,21,0,0,21,1,0,6,6,0,271,21,1404,0.00782999992370606,46,0,0.758159992612641,0.808895731414968,20.7176562449746,163.768139841228,21
"138",2020-07-16,2304,184,263,7,8.6,22,0,1,21,0,0,6,6,0,271,21,1695,0.00708000004291534,25,0.04,0.75584884143846,0.722608930620079,21.7185169328338,181.533672173401,22
"139",2020-07-17,2334,211,263,17,9.3,30,0,0,29,0,1,6,5,0,271,29,1787,0.00726999998092651,21,0,0.718555860946664,0.747684620359456,28.6304641628223,208.311308219155,30
"140",2020-07-18,2360,230,263,16,10.6,26,0,0,24,2,1,7,6,0,273,24,1551,0.00708999991416931,81,0,0.673810653607635,0.715957781653761,23.7132211339191,227.251702533391,26
"141",2020-07-19,2378,248,263,28,13.3,18,0,0,18,0,1,7,6,0,273,18,2025,0.0212299990653992,22,0,2.10018310246377,2.02715339187385,17.3296097440778,238.763512029517,18
"142",2020-07-20,2408,273,263,47,19.1,30,0,0,27,2,3,9,6,0,275,27,1548,0.0148599994182587,35,0.0285700011253357,1.51631264301018,1.4773047886052,26.2739767168778,265.659097915098,30
"143",2020-07-21,2432,292,263,23,21.9,24,0,0,23,0,3,9,6,0,275,23,1428,0.0161099994182587,15,0,1.59425358068423,1.62703031952564,22.3497456513239,283.744596964634,24
"144",2020-07-22,2459,312,263,13,21.6,27,0,1,23,2,3,10,7,0,277,23,1771,0.00902999997138977,16,0,0.894914938406899,0.93298302550994,23.6349875970518,307.048527403486,27
"145",2020-07-23,2478,320,263,29,24.7,19,0,1,17,1,3,11,8,0,278,17,1667,0.0101999998092651,32,0,1.0007886805206,1.12051659212371,17.6982902575174,314.320757788564,19
"146",2020-07-24,2501,335,263,34,27.1,23,0,1,18,0,3,8,5,0,278,18,2036,0.0122800004482269,83,0,1.17989999587494,1.20992690371463,18.6233692865783,327.990483944651,23
"147",2020-07-25,2513,334,263,26,28.6,12,0,1,10,1,3,9,6,0,279,10,2126,0.00800000011920929,320,0,0.695339339878943,0.869207626869329,10.876690984846,329.881478893856,12
"148",2020-07-26,2520,336,263,21,27.6,7,0,0,6,2,4,11,7,0,281,6,1816,0.0121099996566772,73,0,1.16420113163186,1.19219457106961,5.8761268174405,329.063101776668,7
"149",2020-07-27,2535,338,264,22,24,15,0,1,13,1,4,11,7,1,282,13,1601,0.00874000012874603,24,0,0.861091704992148,0.910389058906934,13.8014861619165,332.838640209829,15
"150",2020-07-28,2555,327,264,14,22.7,20,0,2,17,1,4,12,8,0,283,17,1488,0.00739000022411346,24,0,0.727269863325452,0.803015089632666,18.7807485161951,322.782633223283,20
"151",2020-07-29,2571,322,264,20,23.7,16,2,2,12,2,4,13,9,0,285,14,2254,0.00620999991893768,52,0,0.606996522865808,0.68087132480085,15.8493003418599,318.533907862779,16
"152",2020-07-30,2591,332,264,19,22.3,20,1,0,18,1,4,14,10,0,286,19,1891,0.00898999989032745,134,0,0.839510607042431,0.921990969437971,18.7171359098578,327.057322214358,20
"153",2020-07-31,2601,319,264,18,20,10,0,1,9,1,3,15,12,0,287,9,2129,0.00797999978065491,207,0,0.727286795077667,0.858834193979031,9.88392298268923,314.885714608652,10
"154",2020-08-01,2618,306,264,15,18.4,17,0,0,17,1,2,15,13,0,288,17,1629,0.00551999986171722,83,0.0120500004291534,0.583658283315251,0.594541673876727,16.8240433831993,302.832780897587,17
"155",2020-08-02,2626,291,264,2,15.7,8,0,0,8,0,2,15,13,0,288,8,1340,0.00149000003933907,11,0,0.147786828476266,0.193107350144791,7.97903360592218,290.237347415419,8
"156",2020-08-03,2635,277,264,10,14,9,0,1,7,0,1,14,13,0,288,7,1046,0.0114699995517731,47,0,1.09767790769942,1.16066450733189,7.86373918201607,271.607964774065,9
"157",2020-08-04,2647,265,264,20,14.9,12,0,1,11,1,1,13,12,0,289,11,1699,0.0058899998664856,12,0,0.584869069150148,0.63891075291158,11.8859095304232,262.251456869285,12
"158",2020-08-05,2656,245,264,12,13.7,9,1,0,8,1,1,14,13,0,290,9,1599,0.005,70,0,0.479029358897543,0.53116403819307,8.92354556749627,242.91874044851,9
"159",2020-08-06,2666,221,264,12,12.7,10,0,0,10,1,2,12,10,0,291,10,1639,0.00305000007152557,10,0,0.303150401287472,0.323801097272065,9.94624038180724,219.81191243794,10
"160",2020-08-07,2678,222,264,6,11,12,0,3,9,1,2,12,10,0,292,9,1689,0,39,0,0,0.0257267362141595,12,222,12
"161",2020-08-08,2684,205,264,14,10.9,6,1,1,4,0,1,12,11,0,292,5,1518,0.00725000023841858,95,0,0.682300084433937,0.723168648189183,5.93950166010621,202.519568064354,6
"162",2020-08-09,2686,196,264,16,12.9,2,0,1,1,2,2,14,12,0,294,1,1589,0.00441000014543533,102,0,0.414399185753799,0.461725671551154,1.99265119164913,194.559633563229,2
"163",2020-08-10,2698,197,264,8,12.6,12,2,0,10,0,1,14,13,0,294,12,1384,0.00578000009059906,27,0,0.566939767922686,0.654625615397395,11.8793530920663,195.019379928089,12
"164",2020-08-11,2711,201,264,8,10.9,13,2,1,10,0,1,14,13,0,294,12,1460,0.00342000007629395,41,0,0.332658235269098,0.357888885773551,12.9292090804797,199.814252098035,13
"165",2020-08-12,2718,184,264,12,10.9,7,3,0,4,0,2,12,10,0,294,7,1486,0.00268999993801117,7,0,0.267738774808078,0.289878407052593,6.96676410793598,183.126370837174,7
"166",2020-08-13,2740,187,264,11,10.7,22,0,0,22,0,2,11,9,0,294,22,1689,0.00532999992370605,56,0,0.515895121555274,0.590086092726281,21.7987285709734,185.289192853274,22
"167",2020-08-14,2751,181,264,6,10.7,11,4,1,6,1,2,12,10,0,295,10,1882,0.00477999985218048,36,0,0.469028139822923,0.505799299199819,10.9168242113108,179.494518224725,11
"168",2020-08-15,2755,173,264,2,9,4,0,0,4,1,2,13,11,0,296,4,2044,0.00734000027179718,21,0,0.726535620123653,0.791135719562525,3.94846349881061,170.771046323559,4
"169",2020-08-16,2759,155,264,26,10.4,4,0,1,3,0,2,13,11,0,296,3,1196,0.00501999974250793,22,0,0.492932651234769,0.541432662989735,3.97377552098307,153.645068584125,4
"170",2020-08-17,2782,169,265,8,10.4,23,1,4,18,1,1,11,10,1,297,19,1358,0.00662999987602234,32,0,0.647736678535132,0.713935803040333,22.7817520771166,167.058742159616,23
"171",2020-08-18,2808,188,265,15,11.4,26,1,1,24,0,1,9,8,0,297,25,1888,0.00583000004291534,77,0.0519500017166138,0.76372469278389,0.660672395533303,25.6614094215769,185.453798850258,26
"172",2020-08-19,2832,197,265,23,13,24,4,3,15,2,1,9,8,0,299,19,1519,0.0118499994277954,25,0.04,1.23057960691847,1.19196379374769,21.5853694069634,192.700935430094,24
"173",2020-08-20,2849,205,266,24,14.9,17,1,0,16,3,0,8,8,1,302,17,1607,0.00995999991893768,103,0,0.936007009925898,1.08274228862075,16.7178201158513,201.597242573501,17
"174",2020-08-21,2870,212,266,16,16.3,21,3,2,16,0,0,8,8,0,302,19,1804,0.00721000015735626,116,0.00861999988555908,0.729518764093518,0.723489919727478,20.7541964810023,209.257350209078,21
"175",2020-08-22,2889,222,266,16,18.3,19,1,0,18,1,0,9,9,0,303,19,1864,0.00589999973773956,73,0,0.567764559171221,0.646068787273208,18.8086978245448,219.764785107839,19
"176",2020-08-23,2906,232,266,13,16.4,17,0,1,15,0,0,9,9,0,303,15,694,0.0172899997234344,5,0,1.71663230444399,1.70521282753429,15.5433677629701,224.937421400604,17
"177",2020-08-24,2925,248,266,19,18,19,2,0,17,1,1,10,9,0,304,19,1142,0.00962999999523163,58,0,0.91645499954621,1.07158710723331,18.6912103225043,243.969482104266,19
"178",2020-08-25,2939,250,266,23,19.1,14,0,1,13,4,2,13,11,0,308,13,1647,0.0145700001716614,73,0,1.3951622257399,1.44241611261255,13.6783629355908,243.814671838285,14
"179",2020-08-26,2957,258,266,15,18,18,1,4,13,0,2,13,11,0,308,14,1832,0.0049099999666214,41,0,0.480251998870817,0.522175033984437,17.880767336674,255.802712347278,18
"180",2020-08-27,2970,261,266,16,16.9,13,1,3,9,1,2,11,9,0,309,10,1469,0.00612999975681305,9,0,0.609267228874044,0.645516974594226,12.8919547080838,258.180017880986,13
"181",2020-08-28,2998,271,266,20,17.4,28,0,3,21,1,1,11,10,0,310,21,2137,0.00607999980449677,35,0,0.598202559033591,0.667171955577722,23.7772254426123,268.125147378473,28
"182",2020-08-29,3019,285,266,12,16.9,21,0,2,18,0,1,11,10,0,310,18,1790,0.00726000010967255,11,0.0909099960327148,0.777091068999096,0.750389059843236,19.7519481610865,281.072512550537,21
"183",2020-08-30,3039,299,267,16,17.3,20,0,6,12,2,1,12,11,1,312,12,1402,0.00428000003099442,33,0,0.418157494317364,0.441882701489072,17.9110145176382,296.782778397819,20
"184",2020-08-31,3059,307,267,13,16.4,20,1,3,16,1,1,13,12,0,313,17,1353,0.00517000019550324,54,0,0.497157801315983,0.552005108230866,19.8501208545542,304.293358961656,20
"185",2020-09-01,3084,311,267,18,15.7,25,1,2,22,0,1,13,12,0,313,23,1361,0.0154299998283386,22,0.0909099960327148,1.6630693911127,1.60897923748964,24.3216774816608,301.827899860717,25
"186",2020-09-02,3120,321,267,15,15.7,36,1,9,26,0,1,11,10,0,313,27,1528,0.00261999994516373,51,0,0.253537676770752,0.280899692617486,35.8786040218468,319.556736704179,36
"187",2020-09-03,3142,322,267,24,16.9,22,1,4,17,1,1,10,9,0,314,18,1493,0.00938000023365021,133,0.00751999974250793,0.922785997207461,1.05861553469465,21.70544152074,316.730676093237,22
"188",2020-09-04,3164,326,267,24,17.4,22,0,3,19,3,1,13,12,0,317,19,2705,0.00813000023365021,258,0.00774999976158142,0.809691210614641,0.865600128619132,21.7271832354882,321.319038672061,22
"189",2020-09-05,3189,333,267,17,18.1,25,1,11,13,2,1,15,14,0,319,14,2256,0.00398999989032745,164,0,0.371960320354493,0.42658712455435,24.9076530243461,330.803461221947,25
"190",2020-09-06,3210,335,267,26,19.6,21,1,3,16,1,1,16,15,0,320,17,1310,0.00611000001430511,192,0.03125,0.932363516560566,0.674248258363657,19.7189185270008,329.461041561487,21
"191",2020-09-07,3251,360,267,29,21.9,41,2,6,33,0,1,14,13,0,320,35,1290,0.0147300004959106,44,0,1.4244153403092,1.48461774169018,40.1158973044006,350.906372273835,41
"192",2020-09-08,3303,397,267,24,22.7,52,0,14,36,3,1,16,15,0,323,36,1097,0.0127600002288818,4,0,1.27136423715562,1.25074639256783,49.1883467728912,388.049268578828,52
"193",2020-09-09,3348,428,267,15,22.7,45,2,10,31,0,1,15,14,0,323,33,1587,0.0144900000095367,29,0,1.42299690687715,1.44584316017152,42.1672475403021,417.199452946948,45
"194",2020-09-10,3425,490,267,33,24,77,1,21,52,2,2,16,14,0,325,53,1959,0.0127600002288818,61,0,1.23746734892968,1.23136210992067,72.8369251988905,479.247044291629,77
"195",2020-09-11,3455,504,267,60,29.1,30,0,1,25,0,1,14,13,0,325,25,2314,0.0155599999427795,93,0.0752699995040894,1.78670335776785,1.55423660237013,25.2078808907279,488.030878757074,30
"196",2020-09-12,3504,529,269,47,33.4,49,0,4,42,1,0,14,14,2,326,42,1900,0.0168400001525879,26,0,1.66126688940379,1.7182057611099,44.7626666238685,513.415491524439,49
"197",2020-09-13,3539,542,270,31,34.1,35,1,5,29,1,1,13,12,1,327,30,1199,0.0166799998283386,44,0,1.6089557356539,1.68786621261963,34.1440204696699,526.535303152036,35
"198",2020-09-14,3607,592,272,59,38.4,68,0,19,49,1,1,13,12,2,328,49,2394,0.0141999995708466,218,0.0412799978256226,1.6460121936674,1.44955524315446,66.5696999416386,574.719640111226,68
"199",2020-09-15,3680,641,273,41,40.9,73,0,15,55,1,1,13,12,1,329,55,2961,0.0121599996089935,28,0,1.20460886056306,1.1848641408707,68.8250841273093,627.30688955646,73
"200",2020-09-16,3757,681,274,41,44.6,77,0,7,67,1,0,13,13,1,330,67,1887,0.0190799999237061,162,0.00616999983787537,1.80592971350752,1.86640785341688,71.8542769105994,659.190486210719,77
"201",2020-09-17,3807,706,278,57,48,50,2,4,38,2,2,13,11,4,332,40,2512,0.0191100001335144,208,0.00481000006198883,1.80164707162801,1.88631004981672,42.7220091640653,683.443461745752,50
"202",2020-09-18,3895,774,278,47,46.1,88,1,6,78,0,2,13,11,0,332,79,2409,0.0128699994087219,281,0.0213499999046326,1.37558284568078,1.29752920054723,83.0728661902747,755.118967484463,88
"203",2020-09-19,3965,824,280,47,46.1,70,2,4,60,0,2,12,10,2,332,62,2101,0.0214199995994568,161,0,1.98954107685494,2.05387039138104,63.8125273694475,794.927783103625,70
"204",2020-09-20,4008,856,280,76,52.6,43,1,4,34,2,2,13,11,0,334,35,2847,0.0186199998855591,112,0,1.79152212484578,1.84027572629071,37.8880423462315,828.804692810691,43
"205",2020-09-21,4117,936,280,55,52,109,2,22,82,1,3,14,11,0,335,84,2949,0.0189900004863739,73,0,1.85312744653596,1.86353622924075,103.239532727162,905.240507531234,109
"206",2020-09-22,4226,1015,280,85,58.3,109,0,27,81,3,3,17,14,0,338,81,2507,0.0135599994659424,64,0.03125,1.4000357316654,1.42401054979126,105.988953248373,989.799846260479,109
"207",2020-09-23,4331,1073,281,67,62,105,0,25,75,2,3,18,15,1,340,75,1896,0.0168799996376038,7,0.571430015563965,1.89198578149472,1.74958299468041,97.4836145818877,1036.99891261821,105
"208",2020-09-24,4433,1128,282,38,59.3,102,2,19,75,2,3,20,17,1,342,77,2730,0.0128199994564056,55,0,1.25668217292594,1.28905757447569,94.2840121533797,1102.86189232484,102
"209",2020-09-25,4552,1191,284,57,60.7,119,5,16,86,3,3,22,19,2,345,91,3291,0.0133700001239777,59,0.0339000010490417,1.37315732745982,1.36368633190947,104.784051212544,1161.99785707846,119
"210",2020-09-26,4636,1237,286,76,64.9,84,3,14,65,3,4,23,19,2,348,68,3437,0.0299699997901916,12,0,2.98657260883992,2.90067373210611,78.3985281997802,1171.48499092835,84
"211",2020-09-27,4718,1267,287,109,69.6,82,2,12,64,2,4,24,20,1,350,66,2684,0.0331599998474121,13,0,3.30001629923819,3.24973967661712,74.1375928830868,1192.85348761926,82
"212",2020-09-28,4833,1337,288,86,74,115,3,11,97,6,4,29,25,1,356,100,3135,0.0258400011062622,192,0.0104200005531311,2.49501182970644,2.58342838077588,106.575434412035,1277.8435580889,115
"213",2020-09-29,4940,1368,291,58,70.1,107,5,18,74,4,3,29,26,3,360,79,2165,0.0263299989700317,79,0.0253200006484985,2.62944419881239,2.65251323072952,93.3162590808483,1304.21066357722,107
"214",2020-09-30,5023,1397,291,107,75.9,83,1,10,67,5,5,32,27,0,365,68,3170,0.0305999994277954,281,0.0142299997806549,2.92670611777675,3.28280417977999,74.470720477545,1324.49406628133,83
"215",2020-10-01,5123,1432,293,105,85.4,100,2,11,78,3,5,31,26,2,368,80,3844,0.0226300001144409,120,0.00833000004291534,2.21971040476944,2.29495004727714,87.8509153647268,1375.63138502861,100
"216",2020-10-02,5219,1482,294,115,93.7,96,0,13,79,1,5,31,26,1,369,79,3362,0.021710000038147,197,0,2.05082945007727,2.17525828349749,89.1268740493283,1428.10161191272,96
"217",2020-10-03,5292,1494,295,65,92.1,73,2,6,64,5,6,33,27,1,374,66,3113,0.0301999998092651,485,0.0103100001811981,2.75188853513406,2.90097410238259,68.7791329195837,1421.0912815433,73
"218",2020-10-04,5350,1476,295,77,87.6,58,1,7,47,3,6,34,28,0,377,48,3118,0.0291899991035461,102,0,2.82653469580301,2.85223236856397,52.5940112829598,1402.01584695102,58
"219",2020-10-05,5428,1477,295,82,87,78,3,13,59,3,6,35,29,0,380,62,3821,0.0177999997138977,238,0.00839999973773956,1.72488294763206,1.68769299018417,73.1035152866427,1431.82083997373,78
"220",2020-10-06,5504,1450,296,139,98.6,76,5,15,53,2,7,36,29,1,382,58,2158,0.0194599997997284,55,0,1.89763576899295,1.91093669237052,71.0481839738129,1401.20459934532,76
"221",2020-10-07,5605,1464,296,174,108.1,101,12,22,63,3,10,38,28,0,385,75,2268,0.0313100004196167,76,0,3.02948297575472,3.17384904818649,92.9707166622647,1385.34838924741,101
"222",2020-10-08,5685,1423,296,85,105.3,80,5,14,55,2,9,38,29,0,387,60,2434,0.0271199989318848,182,0,2.52332100153698,2.53969541336868,71.3151391577719,1359.32405035849,80
"223",2020-10-09,5770,1426,296,97,102.7,85,5,19,59,2,9,39,30,0,389,64,2508,0.0207299995422363,247,0.00810000002384186,1.95976547578285,2.04738252261631,80.7757576536953,1376.4411002214,85
"224",2020-10-10,5835,1411,297,67,103,65,5,7,51,6,9,45,36,1,395,56,2628,0.0300600004196167,21,0,2.98216991705371,2.90235504344978,60.0384542903558,1336.37962506593,65
"225",2020-10-11,5899,1376,297,140,112,64,6,6,48,5,10,48,38,0,400,54,2660,0.0233100008964539,238,0.0168099999427795,2.2776184393012,2.54514399575164,57.8189141604487,1320.42270156995,64
"226",2020-10-12,5961,1348,297,63,109.3,62,2,14,43,3,10,48,38,0,403,45,1994,0.0150499999523163,237,0.0126600003242493,1.47961093598233,1.49827003833413,57.8192496729513,1312.62996798085,62
"227",2020-10-13,6046,1370,298,74,100,85,4,10,68,1,7,47,40,1,404,72,2117,0.0302300000190735,18,0,2.9975133508374,2.92986062563059,78.1727075319468,1297.17512942732,85
"228",2020-10-14,6113,1375,300,84,87.1,67,1,16,49,2,7,47,40,2,406,50,3004,0.0296300005912781,110,0.0363599991798401,2.98677333609447,2.94030219642348,63.3516809891256,1302.17122720095,67
"229",2020-10-15,6199,1402,300,107,90.3,86,3,25,52,5,8,51,43,0,411,55,2119,0.021710000038147,105,0.00952000021934509,2.11344829603708,2.16742403521109,77.9386471157415,1349.45424102308,86
"230",2020-10-16,6274,1423,301,78,87.6,75,2,10,59,4,8,49,41,1,415,61,3126,0.0214299988746643,280,0.0035699999332428,1.99617664308598,2.08087147000107,68.8406311464431,1372.62652658014,75
"231",2020-10-17,6321,1405,302,64,87.1,47,1,10,36,6,8,51,43,1,421,37,3037,0.0214000010490417,149,0,2.03991849296735,2.03219961884934,45.6615179007384,1354.17385541993,47
"232",2020-10-18,6378,1372,305,74,77.7,57,1,11,40,2,6,49,43,3,423,41,1144,0.0271000003814697,37,0.0540500020980835,2.79443272769098,2.54250250864777,49.968225319647,1304.00988142819,57
"233",2020-10-19,6442,1350,307,69,78.6,64,1,6,57,3,6,48,42,2,426,58,1334,0.0374799990653992,27,0,3.67364575703472,3.99050645243198,60.2214663212635,1262.05137127079,64
"234",2020-10-20,6520,1354,309,46,74.6,78,3,14,57,4,5,47,42,2,430,60,1595,0.0250799989700317,48,0.0208299994468689,2.49558358677117,2.51888595528944,71.344652286987,1294.07765327634,78
"235",2020-10-21,6608,1376,312,69,72.4,88,1,46,40,4,4,46,42,3,434,41,2258,0.0305599999427795,446,0.00897000014781952,2.69989274913919,3.0357961759382,85.0369633976116,1310.11857646618,88
"236",2020-10-22,6674,1363,312,88,69.7,66,2,24,36,2,3,46,43,0,436,38,2238,0.0268099999427795,87,0.0114900004863739,2.62367354469915,2.59364998351671,60.2319627082117,1299.58329398138,66
"237",2020-10-23,6753,1365,313,92,71.7,79,1,13,64,2,3,39,36,1,438,65,2768,0.0245700001716614,65,0.0153799998760223,2.4359145946735,2.50500775798084,75.1921529807519,1306.03521259579,79
"238",2020-10-24,6818,1358,317,63,71.6,65,2,17,41,2,3,39,36,4,440,43,2358,0.0211999988555908,191,0,1.96114544140773,2.04434781537544,58.5045348852516,1310.77112498074,65
"239",2020-10-25,6888,1339,319,69,70.9,70,1,24,42,3,3,41,38,2,443,43,1751,0.0308400011062622,77,0,2.95409419787008,3.27088586826896,64.7473650218291,1268.85399451696,70
"240",2020-10-26,6961,1298,320,77,72,73,1,16,51,4,3,42,39,1,447,52,995,0.0392000007629395,121,0.0165299999713898,3.67420526484435,4.0900983324607,64.6118331657251,1213.42614325214,73
"241",2020-10-27,7039,1268,322,61,74.1,78,0,15,60,1,3,34,31,2,448,60,1354,0.0288000011444092,116,0,2.65273479928776,2.87496244539003,72.1774404512604,1208.3499082033,78
"242",2020-10-28,7151,1275,325,94,77.7,112,2,69,38,2,2,32,30,3,450,40,1900,0.0405299997329712,166,0.01807000041008,3.87253724882471,4.21631665115759,106.253031854157,1187.44039035125,112
"243",2020-10-29,7215,1260,326,65,74.4,64,0,18,42,9,2,40,38,1,459,42,2190,0.0292199993133545,96,0,2.79929127280168,2.87674257586667,57.9150511314927,1197.45153394478,64
"244",2020-10-30,7265,1229,328,122,78.7,50,1,9,36,4,2,43,41,2,463,37,2789,0.0358599996566772,105,0.0571400022506714,3.66320799166528,3.55354585097262,43.5964047879268,1149.16166173951,50
"245",2020-10-31,7304,1159,329,83,81.6,39,0,5,32,2,2,42,40,1,465,32,2352,0.0276399993896484,322,0,2.43116224997955,2.72055257616772,35.620372158311,1109.03160410883,39
"246",2020-11-01,7354,1118,332,50,78.9,50,1,6,40,1,2,40,38,3,466,41,1714,0.0256699991226196,104,0,2.42015283257261,2.53076163356782,45.2403565492634,1070.01752736772,50
"247",2020-11-02,7418,1070,332,56,75.9,64,3,8,47,6,2,45,43,0,472,50,1030,0.0174800002574921,14,0.0714300012588501,1.82034677038704,1.68461951667609,56.3859307634292,1035.45891833739,64
"248",2020-11-03,7489,998,333,36,72.3,71,1,36,33,1,2,46,44,1,473,34,1456,0.0219799995422363,13,0,2.17854862719511,2.20283838729003,68.6864572749667,959.443657659317,71
"249",2020-11-04,7554,922,337,53,66.4,65,5,1,51,1,1,43,42,4,474,56,1466,0.0272900009155273,295,0.0033899998664856,2.32863096551825,2.59609233878082,54.6874734716362,883.925902515154,65
"250",2020-11-05,7601,879,337,45,63.6,47,0,6,34,5,2,46,44,0,479,34,2536,0.0240499997138977,41,0,2.36673648717286,2.56171360999284,38.5729905424239,842.107608435019,47
"251",2020-11-06,7674,872,341,79,57.4,73,1,12,57,4,3,48,45,4,483,58,2342,0.0234800004959106,116,0.0258599996566772,2.35923194148077,2.56775773223339,67.5734085602115,835.517452836283,73
"252",2020-11-07,7709,838,346,75,56.3,35,3,4,25,3,4,48,44,5,486,28,2499,0.0276099991798401,142,0,2.61254782091709,2.69387494018421,30.702760069768,799.175462088058,35
"253",2020-11-08,7746,776,346,47,55.9,37,1,5,29,1,4,49,45,0,487,30,1176,0.0204099988937378,92,0.0108700001239777,1.97178223268467,1.96875125039442,33.9509933728781,748.865695245115,37
"254",2020-11-09,7816,744,350,31,52.3,70,3,24,41,7,4,48,44,4,494,44,711,0.0210999989509583,20,0.1,2.3258685710166,2.09239460025568,66.1851703128915,713.312879836165,70
"255",2020-11-10,7883,753,350,51,54.4,67,0,11,54,3,5,49,44,0,497,54,1374,0.0334800004959106,17,0,3.30708272332,3.28371090951281,61.8330817956184,708.839085038902,67
"256",2020-11-11,7940,753,353,78,58,57,0,6,49,2,5,48,43,3,499,49,2375,0.0261100006103516,241,0.0290499997138977,2.63808491516186,2.66890807553307,52.7076396987611,717.772503942186,57
"257",2020-11-12,7982,743,355,58,59.9,42,1,8,31,3,3,45,42,2,502,32,2318,0.0215700006484985,214,0.00467000007629395,2.01416435701211,2.11553134114496,38.8570087312375,716.461171478421,42
"258",2020-11-13,8020,719,357,81,60.1,38,1,7,26,0,3,38,35,2,502,27,2719,0.0217000007629395,200,0,2.02131901591067,2.14446862268701,33.0321754059536,693.227189514098,38
"259",2020-11-14,8041,696,357,51,56.7,21,3,2,14,3,3,39,36,0,505,17,1710,0.015789999961853,245,0.0163300001621246,1.58576726212221,1.58936613279793,18.5219356077816,676.427481353881,21
"260",2020-11-15,8071,652,360,29,54.1,30,1,1,25,0,2,37,35,3,505,26,984,0.0152400004863739,306,0.00653999984264374,1.31762794034426,1.57538751703935,26.3924749754587,636.765141692273,30
"261",2020-11-16,8115,613,363,11,51.3,44,0,3,39,3,2,35,33,3,508,39,735,0.0122399997711182,53,0,1.1416751055548,1.19597168839997,41.2104035874432,600.589164079555,44
"262",2020-11-17,8156,590,363,38,49.4,41,1,10,29,1,2,34,32,0,509,30,1828,0.020789999961853,38,0,2.03666237568421,2.05411655491583,38.9164765287526,568.690705065467,41
"263",2020-11-18,8197,583,363,66,47.7,41,3,6,30,1,2,34,32,0,510,33,2684,0.0204900002479553,20,0.05,2.07082694768906,1.96499358948473,37.7881307218852,561.590309419972,41
"264",2020-11-19,8217,567,364,53,47,20,2,1,17,0,2,32,30,1,510,19,2476,0.0121200001239777,187,0.0160399997234344,1.23952685900304,1.19882640309611,19.5823547263877,554.536585782201,20
"265",2020-11-20,8242,524,364,29,39.6,25,1,2,20,1,2,32,30,0,511,21,2643,0.00757000029087067,222,0.0225200009346008,0.872842966012306,0.814607275205266,22.6749475533229,515.88916752101,25
"266",2020-11-21,8271,494,365,27,36.1,29,4,4,19,2,2,33,31,1,513,23,1495,0.0187300002574921,71,0,1.7880811229215,1.84233395324239,26.2706884650896,478.335656598011,29
"267",2020-11-22,8298,480,368,26,35.7,27,3,4,19,3,4,33,29,3,516,22,1220,0.0147500002384186,36,0,1.4327229530948,1.49374693328385,25.4410371718593,467.80444738602,27
"268",2020-11-23,8338,462,370,20,37,40,2,10,25,1,3,28,25,2,517,27,922,0.0173500001430511,13,0,1.71087701945381,1.70639149084687,36.1808176523436,447.982879828991,40
"269",2020-11-24,8382,472,370,21,34.6,44,2,7,34,1,3,24,21,0,518,36,1403,0.00855000019073486,41,0.0975599956512451,1.10772923056108,0.90226576611796,42.292813201385,462.727995307048,44
"270",2020-11-25,8437,480,371,38,30.6,55,4,10,39,2,2,24,22,1,520,43,2618,0.0122200000286102,72,0.0138900005817413,1.22646989281736,1.18955821063736,52.0647593491684,469.56010436281,55
"271",2020-11-26,8482,495,372,60,31.6,45,3,4,37,3,2,24,22,1,523,40,3059,0.0143799996376038,224,0.00446000009775162,1.37031553193196,1.41725469393457,43.0279723927475,482.97115836025,45
"272",2020-11-27,8528,506,374,56,35.4,46,2,3,40,3,1,25,24,2,526,42,3154,0.0177600002288818,336,0.00298000007867813,1.63370546556817,1.6796667128745,43.7831947339651,491.340393699675,46
"273",2020-11-28,8573,509,375,60,40.1,45,2,3,40,2,1,26,25,1,528,42,2597,0.0119400000572205,191,0,1.11220158352229,1.19137669173325,44.1716176677835,498.96079506909,45
"274",2020-11-29,8618,523,377,23,39.7,45,0,4,38,5,1,29,28,2,533,38,898,0.0245000004768372,12,0,2.41769235474723,2.49495914562144,40.3707690112969,500.57663665548,45
"275",2020-11-30,8662,530,378,45,43.3,44,1,7,35,1,1,26,25,1,534,36,1135,0.0229099988937378,61,0,2.17415123280873,2.51035240690328,41.6119974018776,509.565517305421,44
"276",2020-12-01,8715,550,378,34,45.1,53,2,11,39,3,1,28,27,0,537,41,1906,0.0141700005531311,113,0.0176999998092651,1.43675686145195,1.44770892104944,50.9553635755857,535.98658455054,53
"277",2020-12-02,8757,564,379,50,46.9,42,1,5,34,6,1,32,31,1,543,35,2859,0.0101400005817413,81,0.0123500001430511,1.0200888324757,1.10583813115983,39.3668537111186,553.797299802025,42
"278",2020-12-03,8795,563,380,40,44,38,0,6,31,3,1,34,33,1,546,31,3327,0.0102199995517731,202,0,0.963500666158941,1.14450762053006,36.4703222363035,553.380368356092,38
"279",2020-12-04,8837,566,382,54,43.7,42,1,5,32,2,1,32,31,2,548,33,2994,0.0110199999809265,165,0.0121200001239777,1.10774548791865,1.143059796728,37.3517359206297,554.881288820497,42
"280",2020-12-05,8872,555,382,45,41.6,35,3,2,29,1,1,32,31,0,549,32,2277,0.0184500002861023,209,0,1.68988940673592,1.77497547293089,33.0410271980293,538.367815465821,35
"281",2020-12-06,8911,548,383,33,43,39,0,7,30,1,2,32,30,1,550,30,1397,0.0157500004768372,20,0,1.55276998349623,1.54930459491374,36.1739118163847,532.910122512627,39
"282",2020-12-07,8964,550,384,24,40,53,0,4,44,2,1,32,31,1,552,44,1068,0.0168499994277954,25,0.04,1.73795053878184,1.72484670164981,46.643911237371,533.048890467138,53
"283",2020-12-08,9011,555,384,58,43.4,47,1,1,44,0,1,29,28,0,552,45,2367,0.01942999958992,69,0,1.88796424586785,1.90010330025026,44.4933779910969,536.418328556862,47
"284",2020-12-09,9066,566,386,39,41.9,55,2,3,48,1,3,26,23,2,553,50,2911,0.00962000012397766,167,0.00598999977111816,0.942305078709412,1.06855916616909,52.1644747782392,556.541854489667,55
"285",2020-12-10,9110,564,386,57,44.3,44,2,0,42,1,3,25,22,0,554,44,3091,0.0139100003242493,252,0.00397000014781952,1.3160709255012,1.42764670003934,42.9730956358828,550.836953150862,44
"286",2020-12-11,9149,548,386,49,43.6,39,6,2,30,1,2,25,23,0,555,36,3047,0.0118099999427795,32,0,1.16872587936503,1.18683765357655,37.2538722548036,536.642277656455,39
"287",2020-12-12,9178,533,387,56,45.1,29,2,5,22,0,2,22,20,1,555,24,2616,0.0156700003147125,24,0,1.5527545766397,1.52884098865088,28.3391360103814,518.323312230553,29
"288",2020-12-13,9218,531,388,28,44.4,40,5,2,33,0,2,21,19,1,555,38,1502,0.0119799995422363,47,0,1.16165005244926,1.19558719488075,39.2171889612991,520.061245748679,40
"289",2020-12-14,9260,528,388,19,43.7,42,3,4,35,2,2,22,20,0,557,38,917,0.0174500000476837,20,0,1.70775347318313,1.70083500319399,40.8491815866844,512.009680993931,42
"290",2020-12-15,9308,538,389,51,42.7,48,2,7,38,1,1,22,21,1,558,40,2079,0.0134700000286102,49,0,1.31598355542672,1.41624883886194,46.0665125536732,525.444593846905,48
"291",2020-12-16,9362,554,389,53,44.7,54,3,4,46,0,1,20,19,0,558,49,2312,0.0168700003623962,94,0,1.62109064164007,1.72111783343084,51.5913554903984,538.073692687361,54
"292",2020-12-17,9399,549,390,61,45.3,37,1,5,29,2,0,20,20,1,560,30,3207,0.0134099996089935,83,0.0241000008583069,1.36796865706023,1.37277197962263,34.272227853987,535.681769727963,37
"293",2020-12-18,9441,539,390,23,41.6,42,3,4,35,0,0,19,19,0,560,38,3298,0.00727999985218048,170,0.00587999999523163,0.72113724082124,0.748931896663885,41.5140410906512,532.107056522658,42
"294",2020-12-19,9480,536,390,46,40.1,39,1,7,29,3,0,22,22,0,563,30,2799,0.0117900002002716,140,0,1.12283805922287,1.17016782503652,36.4026396293744,525.327161378156,39
"295",2020-12-20,9524,531,390,24,39.6,44,5,2,34,0,0,19,19,0,563,39,1360,0.0161800003051758,51,0,1.55951810170369,1.66956349107,39.9214182805324,516.314695050325,44
"296",2020-12-21,9599,552,390,28,40.9,75,7,8,59,1,0,18,18,0,564,66,1365,0.00658999979496002,32,0.03125,0.715486737302823,0.705135184226579,73.1625795706363,544.996120045321,75
"297",2020-12-22,9680,593,390,66,43,81,5,7,67,2,0,18,18,0,566,72,3021,0.0225099992752075,48,0,2.21579367254487,2.27937597488364,76.1708248000557,569.698598700459,81
"298",2020-12-23,9782,662,390,52,42.9,102,5,6,90,1,1,16,15,0,567,95,2652,0.0199800002574921,199,0.0150800001621246,1.96379799070964,1.93021415418375,97.6915967040484,638.945652821895,102
"299",2020-12-24,9855,690,390,57,42.3,73,11,5,55,2,1,16,15,0,569,66,3469,0.01557000041008,144,0,1.49494413015686,1.51465392428983,69.2502865670577,671.707541382876,73
"300",2020-12-25,9919,720,390,52,46.4,64,6,2,55,0,1,13,12,0,569,61,2537,0.0295600008964539,161,0,2.77960423551903,2.91603356325652,59.9931564763148,684.509387917159,64
"301",2020-12-26,10012,762,390,86,52.1,93,5,4,83,2,2,15,13,0,571,88,951,0.0199800002574921,50,0,1.89819982466283,1.92141906116661,89.0377437170867,736.349553550228,93
"302",2020-12-27,10123,827,391,35,53.7,111,8,6,95,2,4,15,11,1,573,103,1480,0.0270300006866455,32,0.0625,2.77806885028012,2.59206059440499,103.925675253205,786.257606159225,111
"303",2020-12-28,10258,924,391,65,59,135,15,7,111,1,2,15,13,0,574,126,1188,0.04125,39,0.0256399989128113,4.07538385962507,4.2902940995628,123.893801888982,857.221213852538,135
"304",2020-12-29,10378,1000,391,113,65.7,120,5,15,100,3,4,14,10,0,577,105,1880,0.0505299997329712,25,0.04,5.03918107600976,4.91392048318562,110.616879543126,910.63694802977,120
"305",2020-12-30,10515,1091,391,88,70.9,137,12,10,115,3,5,15,10,0,580,127,2458,0.0573600006103516,62,0,5.59487625000969,5.69091618693442,124.399370728398,982.753649328207,137
"306",2020-12-31,10640,1178,391,147,83.7,125,0,9,116,2,5,15,10,0,582,116,2652,0.0331800007820129,144,0,3.14711595400209,3.22840867970144,118.526058629733,1112.25600918815,125
"307",2021-01-01,10757,1233,392,89,89,117,0,5,111,2,6,15,9,1,584,111,2759,0.0391400003433228,134,0.0149300003051758,3.80186246070242,4.02027823252364,108.516282098944,1149.87005250449,117
"308",2021-01-02,10869,1291,392,134,95.9,112,4,8,100,2,6,17,11,0,586,104,2369,0.0295499992370605,431,0,2.50014100687844,2.8562982874187,107.388992051387,1233.76143017635,112
"309",2021-01-03,10992,1317,393,107,106.1,123,0,5,118,3,5,20,15,1,589,118,1516,0.0600299978256226,126,0.0238100004196167,5.72506313986087,6.268632508101,111.019903502648,1183.28993994057,123
"310",2021-01-04,11168,1429,393,115,113.3,176,5,30,141,5,8,23,15,0,594,146,1386,0.0533900022506714,155,0.00644999980926514,4.86685873393035,5.43861855281515,163.399156303748,1305.66708464422,176
"311",2021-01-05,11311,1505,395,105,112.1,143,2,19,122,6,8,25,17,2,600,124,2417,0.0575099992752075,97,0.0103100001811981,5.56888378145397,5.86358197304874,130.754180100754,1356.37129880351,143
"312",2021-01-06,11495,1601,395,132,118.4,184,11,42,130,7,7,30,23,0,607,141,2627,0.0513899993896484,211,0.0142200005054474,4.86264793880394,5.21549857025491,170.841220904381,1462.94180615542,184
"313",2021-01-07,11610,1633,395,188,124.3,115,2,7,105,6,9,34,25,0,613,107,2311,0.048899998664856,91,0.0109899997711182,4.74637747267502,4.82974582262979,104.993748303769,1495.54944841173,115
"314",2021-01-08,11743,1665,395,186,138.1,133,6,13,113,0,11,32,21,0,613,119,2661,0.0368300008773804,249,0,3.36785678126148,3.86739144108517,124.892798895719,1565.5589089191,133
"315",2021-01-09,11843,1676,397,153,140.9,100,6,2,92,4,11,32,21,2,617,98,3020,0.0324499988555908,375,0.00266999989748001,2.91606027998348,3.13252935039922,94.9321867666693,1589.33005123406,100
"316",2021-01-10,11935,1660,397,120,142.7,92,5,3,82,5,11,36,25,0,622,87,1824,0.0509899997711182,78,0,4.88989272252994,4.8871235472517,82.4557406077709,1516.05206217126,92
"317",2021-01-11,12099,1711,397,66,135.7,164,2,25,135,3,13,36,23,0,625,137,1608,0.0342000007629395,115,0,3.1917354165297,3.36529752932785,154.245648595824,1614.15550910551,164
"318",2021-01-12,12240,1739,398,160,143.6,141,1,22,116,4,13,37,24,1,629,117,2211,0.0705600023269653,74,0.0135099995136261,6.87124311198813,7.48113879641783,124.743293644661,1527.09903972706,141
"319",2021-01-13,12329,1727,402,172,149.3,89,1,9,76,2,11,36,25,4,631,77,2532,0.0375200009346008,173,0.0115600001811981,3.58597125315181,4.02379851500466,81.1033895273528,1617.17602225634,89
"320",2021-01-14,12420,1713,402,130,141,91,2,14,74,9,10,43,33,0,640,76,2581,0.0337100005149841,146,0,3.19052113418313,3.31452700533323,85.6999525669866,1616.07919404274,91
"321",2021-01-15,12515,1681,404,144,135,95,6,7,80,5,11,43,32,2,645,86,2923,0.0372900009155273,206,0.00485000014305115,3.51542897748658,3.91115551016844,87.6386420015506,1576.20415354194,95
"322",2021-01-16,12576,1632,405,119,130.1,61,0,1,58,2,9,41,32,1,647,58,2470,0.0323900008201599,289,0,2.89972098679938,3.07119336085166,56.0174877676817,1548.07827649753,61
"323",2021-01-17,12655,1571,407,74,123.6,79,2,3,71,2,9,41,32,2,649,73,2036,0.026029999256134,32,0,2.5627213967838,2.63580645683205,72.6824132851053,1499.60371603973,79
"324",2021-01-18,12777,1593,408,64,123.3,122,2,45,73,7,10,45,35,1,656,75,1021,0.0391799998283386,48,0,3.74207481990026,4.04248275535715,115.022952813713,1487.28751776327,122
"325",2021-01-19,12851,1534,415,81,112,74,3,24,47,8,9,47,38,7,664,50,2337,0.0410799980163574,89,0,3.95729412053699,4.23447896684079,70.4911374008904,1426.34809545932,74
"326",2021-01-20,12912,1492,415,166,111.1,61,1,8,50,2,7,39,32,0,666,51,3065,0.0225099992752075,163,0.00612999975681305,2.16828803404187,2.25450431601711,57.0389657563719,1434.63013546092,61
"327",2021-01-21,12983,1461,417,81,104.1,71,1,9,60,3,7,39,32,2,669,61,2636,0.0242799997329712,117,0,2.32481217929938,2.6049272030718,67.4851288698639,1400.76677506346,71
"328",2021-01-22,13061,1429,418,94,97,78,1,3,73,5,6,39,33,1,674,74,2311,0.0307200002670288,111,0.00901000022888184,2.97250332958338,3.27894916106894,73.099214247668,1353.67266432321,78
"329",2021-01-23,13110,1365,418,84,92,49,1,4,41,4,9,41,32,0,678,42,2122,0.0329900002479553,276,0,2.91929860409346,3.21082013198337,43.8256680965722,1294.3342131386,49
"330",2021-01-24,13156,1281,419,44,87.7,46,2,9,35,2,8,39,31,1,680,37,1247,0.0224499988555908,36,0,2.18200690357925,2.22811437550373,44.5682873159027,1231.43178518031,46
"331",2021-01-25,13219,1223,419,29,82.7,63,1,18,43,4,7,40,33,0,684,44,825,0.0206100010871887,48,0,1.94768051511234,2.04545896171697,60.4802630450079,1180.75822054647,63
"332",2021-01-26,13281,1159,420,74,81.7,62,1,19,40,8,5,42,37,1,692,41,2354,0.024210000038147,79,0,2.3423896461076,2.58012033850689,58.2968965660466,1110.85617365971,62
"333",2021-01-27,13359,1119,422,80,69.4,78,0,27,50,1,4,32,28,2,693,50,2800,0.0196399998664856,175,0.00570999979972839,1.88205880978528,1.92042911243984,75.3312117912317,1081.65251988776,78
"334",2021-01-28,13397,1058,422,66,67.3,38,1,3,33,3,5,32,27,0,696,34,2355,0.0212299990653992,209,0.0287100005149841,2.18397183723271,2.05038950920557,35.6831873832588,1017.02388974964,38
"335",2021-01-29,13424,952,422,73,64.3,27,1,2,24,3,4,33,29,0,699,25,2847,0.0122899997234344,180,0.00555999994277954,1.18898015204223,1.22089578615048,26.4728761800982,931.92712493814,27
"336",2021-01-30,13443,855,423,41,58.1,19,1,6,12,2,5,35,30,1,701,13,2155,0.0157799994945526,216,0,1.43424288953019,1.55693413281599,18.6693533811858,833.253626224141,19
"337",2021-01-31,13485,796,424,25,55.4,42,3,5,34,4,6,34,28,1,705,37,922,0.0195200002193451,24,0,1.90247782264653,1.91052848243439,40.7516988945228,769.144657298382,42
"338",2021-02-01,13529,709,424,27,55.1,44,6,7,29,4,5,31,26,0,709,35,548,0.0292000007629395,29,0,2.77324097367259,2.84623795266355,40.2787114467341,674.131611878128,44
"339",2021-02-02,13572,647,425,59,53,43,4,5,32,3,5,29,24,1,712,36,2439,0.0221399998664856,107,0.0280399990081787,2.23879574109322,2.20221018809198,39.5707276207791,621.312799184557,43
"340",2021-02-03,13635,632,425,54,49.3,63,4,22,36,2,4,28,24,0,714,40,2865,0.0129100000858307,212,0,1.20205233168362,1.30102246997361,61.1473291920501,618.527801234391,63
"341",2021-02-04,13717,634,425,51,47.1,82,3,43,33,2,5,27,22,0,716,36,2814,0.0127900004386902,90,0,1.23936161275738,1.26454702398277,78.2087776082172,620.065694544715,82
"342",2021-02-05,13773,631,427,72,47,56,1,8,46,2,5,23,18,2,718,47,2435,0.0160199999809265,149,0,1.50962461120573,1.61110660089216,53.7417560421154,614.107405586698,56
"343",2021-02-06,13798,600,427,61,49.9,25,1,4,19,3,6,23,17,0,721,20,2369,0.0143499994277954,205,0.0146300005912781,1.43722994427581,1.41789854981757,23.4902534667193,584.707604001578,25
"344",2021-02-07,13823,555,429,33,51,25,1,2,19,3,4,25,21,2,724,20,1004,0.0249000000953674,75,0,2.31692308579693,2.50275607768071,21.178250136266,532.196441281382,25
"345",2021-02-08,13871,553,431,24,50.6,48,1,7,39,2,5,23,18,2,726,40,852,0.0140799999237061,29,0,1.36165266004513,1.4429218402359,46.0341173647892,539.646672568211,48
"346",2021-02-09,13926,573,431,42,48.1,55,5,8,39,0,2,20,18,0,726,44,2244,0.0178299999237061,149,0,1.67198160588368,1.68876971819328,50.6953855035193,556.010361216286,55
"347",2021-02-10,13981,588,432,41,46.3,55,0,5,49,3,4,21,17,1,729,49,2791,0.0125399994850159,100,0,1.21062395581734,1.24755331381313,52.9480299591212,575.376359509455,55
"348",2021-02-11,14039,612,433,51,46.3,58,1,11,44,1,3,18,15,1,730,45,2563,0.0152199995517731,58,0,1.48831968146488,1.57765118340893,54.8122999716301,595.84727961417,58
"349",2021-02-12,14090,615,435,52,43.4,51,0,8,42,3,2,18,16,2,733,42,2612,0.0157000005245209,173,0,1.47247401687786,1.52980720651716,48.9032820324113,598.940915474594,51
"350",2021-02-13,14125,616,435,45,41.1,35,0,4,30,6,2,22,20,0,739,30,2099,0.0219199991226196,46,0.0217400002479553,2.19161390068926,2.19882460099286,32.8340408652607,592.058972433352,35
"351",2021-02-14,14165,589,437,49,43.4,40,0,4,34,4,2,22,20,2,743,34,1175,0.0170200002193451,10,0,1.6876371525511,1.71291735424613,36.9824493809516,571.372431922956,40
"352",2021-02-15,14227,611,438,34,44.9,62,2,8,51,4,2,24,22,1,747,53,867,0.0265300011634827,26,0,2.57575711184093,2.63698638815031,58.5790891023089,583.091008330391,62
"353",2021-02-16,14280,608,438,61,47.6,53,3,13,34,3,2,25,23,0,750,37,1561,0.0333100008964539,23,0,3.28263329541442,3.26830890619032,47.8461169308971,572.606461999607,53
"354",2021-02-17,14338,625,439,50,48.9,58,5,6,44,2,2,26,24,1,752,49,2063,0.0184200000762939,222,0,1.66303983183345,1.75925377158964,53.5549037985989,606.567650492333,58
"355",2021-02-18,14410,642,439,68,51.3,72,3,12,53,3,3,27,24,0,755,56,2348,0.0212899994850159,116,0,2.02877105482213,2.02904841952718,65.9852595994279,618.902440407727,72
"356",2021-02-19,14464,647,440,58,52.1,54,2,16,33,1,3,27,24,1,756,35,2576,0.0151400005817413,96,0,1.45960484650321,1.56434407910371,50.0940559661319,630.252977431066,54
"357",2021-02-20,14513,627,440,66,55.1,49,0,3,45,4,3,27,24,0,760,45,2384,0.0255900001525879,68,0,2.48803264126303,2.51055998248934,46.0145149759057,599.335575330953,49
"358",2021-02-21,14553,613,440,53,55.7,40,0,7,31,2,4,25,21,0,762,31,1000,0.03,28,0,2.91828793774319,2.90115244630213,36.3956915828106,581.276094847191,40
"359",2021-02-22,14618,630,440,32,55.4,65,0,11,54,1,6,24,18,0,763,54,863,0.0150600004196167,66,0,1.39900757396439,1.53548836267612,63.6602867467411,614.370012045312,65
"360",2021-02-23,14673,636,440,47,53.4,55,0,7,47,3,6,26,20,0,766,47,2036,0.019650000333786,84,0,1.88714154149001,1.94739598928324,52.4271027216784,614.71568789335,55
"361",2021-02-24,14721,643,441,60,54.9,48,2,10,36,1,6,25,19,1,767,38,2874,0.0187899994850159,41,0,1.85257147581254,1.84427194591475,46.7515918428352,621.875619866923,48
"362",2021-02-25,14754,638,441,44,51.4,33,1,5,25,1,6,24,18,0,768,26,2376,0.0185199999809265,128,0.00781000018119812,1.79725239528254,1.82617299197302,30.171332231111,617.665767824955,33
"363",2021-02-26,14819,640,441,57,51.3,65,5,12,43,1,6,22,16,0,769,48,2639,0.0181900000572205,181,0,1.70224858691506,1.73347657138654,58.5510204775492,620.68027303399,65
"364",2021-02-27,14865,644,442,71,52,46,0,5,33,3,6,24,18,1,772,33,2535,0.0209100008010864,47,0.0212800002098083,2.09167358794017,2.07516076370847,36.7759310531005,620.112109036264,46
"365",2021-02-28,14931,657,442,50,51.6,66,2,9,54,7,6,29,23,0,779,56,1552,0.0257699990272522,94,0,2.42983222905804,2.55299081632044,62.586972099755,628.690011956054,66
"366",2021-03-01,15007,669,442,55,54.9,76,3,6,65,3,6,30,24,0,782,68,996,0.0291199994087219,45,0,2.78612098089213,2.8531633321887,70.6402503943872,635.945992850662,76
"367",2021-03-02,15074,680,443,62,57,67,1,7,58,3,4,30,26,1,785,59,2006,0.0259200000762939,41,0,2.54008403287961,2.60180862577483,63.3423479285837,649.369433753168,67
"368",2021-03-03,15135,692,443,65,57.7,61,1,5,51,6,5,33,28,0,791,52,2676,0.0209299993515015,109,0,2.01108360016581,2.08827532985546,55.1454801068866,667.320619883952,61
"369",2021-03-04,15189,685,443,61,60.1,54,2,3,49,1,5,32,27,0,792,51,2414,0.0202999997138977,225,0.00444000005722046,1.89477829944008,1.94062335203726,52.2863323179628,661.983090937344,54
"370",2021-03-05,15262,688,444,51,59.3,73,2,9,57,1,2,29,27,1,793,59,2440,0.0188499999046326,154,0,1.77309174122218,1.84932805592265,66.14484053367,666.366954019745,73
"371",2021-03-06,15316,700,445,46,55.7,54,3,3,46,0,2,27,25,1,793,49,1960,0.0224499988555908,25,0,2.21672532780645,2.20775628783597,50.0737795394647,672.482564849496,54
"372",2021-03-07,15356,691,446,55,56.4,40,0,0,38,2,5,26,21,1,795,38,1748,0.0188800001144409,16,0.0625,1.92756463719063,1.8671200598899,36.7010555609059,667.379720857525,40
"373",2021-03-08,15441,735,447,39,54.1,85,2,10,66,6,4,30,26,1,801,68,1167,0.0179900002479553,142,0,1.60384494189182,1.70666554525026,76.0659427756581,714.095116766304,85
"374",2021-03-09,15498,741,447,70,55.3,57,0,8,46,1,3,28,25,0,802,46,2099,0.0304900002479553,57,0,2.96839102599528,3.027068754544,51.5785418372452,701.993467421711,57
"375",2021-03-10,15576,762,447,77,57,78,3,7,65,0,2,25,23,0,802,68,2654,0.0184599995613098,174,0,1.73242004369577,1.80892907728156,72.9108956149138,738.58974203771,78
"376",2021-03-11,15637,760,450,73,58.7,61,1,6,51,1,2,21,19,3,803,52,2325,0.0296799993515015,86,0,2.86213183294239,2.92385074407799,55.3606863382172,721.425415712406,61
"377",2021-03-12,15709,755,450,97,65.3,72,2,4,61,2,2,18,16,0,805,63,2357,0.0212100005149841,134,0,2.00690370187947,2.04935227275805,64.7578476864348,728.129761956481,72
"378",2021-03-13,15767,763,450,56,66.7,58,4,4,45,4,4,22,18,0,809,49,2351,0.018289999961853,95,0,1.75796361039724,1.7457383622446,51.4724199102401,739.213395745167,58
"379",2021-03-14,15818,770,450,65,68.1,51,1,6,41,2,3,23,20,0,811,42,1536,0.0305999994277954,36,0,2.98992360821207,3.26623160121285,45.7730656668587,729.172870559075,51
"380",2021-03-15,15905,796,451,59,71,87,0,3,80,4,5,25,20,1,815,80,996,0.0281100010871887,13,0,2.77478306073736,2.8534003359876,79.0634384179084,756.831212258189,87
"381",2021-03-16,15982,802,452,85,73.1,77,2,6,66,5,6,27,21,1,820,68,1583,0.0334800004959106,9,0,3.32907291363232,3.23597732693667,69.9855112231878,754.65264707348,77
"382",2021-03-17,16049,808,453,78,73.3,67,2,4,57,3,5,27,22,1,823,59,2841,0.0274600005149841,175,0,2.58666649413362,2.66722144310722,60.2936093935427,770.936209999704,67
"383",2021-03-18,16140,843,454,63,71.9,91,3,4,82,2,5,24,19,1,825,85,2569,0.0295799994468689,160,0,2.78457378450004,2.94497151776147,84.8026451747628,801.372116262648,91
"384",2021-03-19,16253,880,456,118,74.9,113,7,4,95,2,4,24,20,2,827,102,2617,0.0405000019073486,96,0,3.90669019504354,4.20047645145715,98.9334542907146,819.03372329244,113
"385",2021-03-20,16325,901,457,83,78.7,72,3,4,62,5,5,28,23,1,832,65,2012,0.0511899995803833,150,0.00666999995708466,4.81011929460194,5.10710364356176,63.4554381532469,824.143842708854,72
"386",2021-03-21,16390,909,458,88,82,65,8,3,53,3,5,28,23,1,835,61,1307,0.0428499984741211,87,0,4.01757159294665,4.62189301590688,59.653982329273,844.237212087036,65
"387",2021-03-22,16543,989,459,55,81.4,153,4,6,138,5,8,31,23,1,840,142,1148,0.0540100002288818,130,0,4.85160252447233,5.5612191822338,135.782802744512,903.909802213541,158
"388",2021-03-23,16671,1031,460,111,85.1,128,2,2,123,4,9,31,22,1,844,125,1958,0.0326900005340576,152,0,3.03350810643056,3.18838969944729,120.275605240263,975.537192021693,131
"389",2021-03-24,16790,1085,460,94,87.4,119,2,4,108,4,9,32,23,0,848,110,3098,0.0432499980926514,47,0,4.26036547189297,4.66626172015484,105.689300684621,1003.02628402558,122
"390",2021-03-25,16951,1175,461,125,96.3,161,1,5,151,7,10,38,28,1,855,152,2988,0.0344700002670288,281,0,3.15069932082845,3.39045772428954,148.507245395386,1109.34877197091,168
"391",2021-03-26,17087,1251,462,116,96,136,5,2,124,4,11,40,29,1,859,129,2380,0.0638700008392334,117,0,6.08772935512116,6.9406976678515,117.073464996948,1115.9449977611,142
"392",2021-03-27,17223,1334,464,137,103.7,136,1,4,129,5,13,42,29,2,864,130,2460,0.0577199983596802,117,0,5.50994163619764,6.09139188154218,121.297524114139,1203.65305514047,147
"393",2021-03-28,17316,1362,465,142,111.4,93,3,3,84,5,13,43,30,1,869,87,2463,0.0759200000762939,157,0,7.13705954915695,7.77997204282389,78.9887505530454,1189.61699141664,99
"394",2021-03-29,17453,1452,465,120,120.7,137,0,2,130,4,12,45,33,0,873,130,1628,0.0761700010299683,40,0,7.43433823002328,8.85181676940399,114.861070347131,1260.5713395695,157
"395",2021-03-30,17610,1540,466,178,130.3,157,1,7,148,5,13,46,33,1,878,149,1968,0.0421700000762939,64,0,4.0841811097513,4.49716016463695,145.208314286401,1428.46177181918,181
"396",2021-03-31,17827,1664,467,178,142.3,217,2,4,208,8,15,52,37,1,886,210,2988,0.0702799987792969,209,0,6.56855290436469,7.27849889053564,189.538278065686,1470.1699747681,225
"397",2021-04-01,18009,1747,468,208,154.1,182,0,2,179,3,15,50,35,1,889,179,2630,0.0722399997711182,99,0.0100999999046326,6.99857454703552,7.67142231439622,158.78426674811,1530.17940787122,196
"398",2021-04-02,18128,1794,468,230,170.4,119,0,5,114,4,15,52,37,0,893,114,3082,0.0824100017547607,98,0,7.98703224554002,9.6285112190368,102.853131168669,1539.89927470695,149
"399",2021-04-03,18260,1862,468,200,179.4,132,0,0,132,7,15,53,38,0,900,132,2792,0.0830900001525879,36,0,8.20322773783682,10.2208981206438,112.797546240244,1591.12902347981,214
"400",2021-04-04,18260,1815,468,158,181.7,0,0,0,0,0,16,53,37,0,900,0,805,0.114289999008179,51,0,10.7480664955121,11.3659135818693,0,1469.05663762633,178
