"","date","observed_cumulative_cases","observed_active_cases","observed_cumulative_deaths","observed_new_cases","observed_daily_average_cases","observed_new_episodes","observed_new_cases_community_outbreak","observed_new_cases_institution_outbreak","observed_new_cases_sporadic","observed_new_ICU_p_acute_care","observed_census_ICU","observed_census_ICU_p_acute_care","observed_census_acute_care","observed_new_deaths","cumulative_hosp","observed_new_community_cases","num_non_ltch_tests","non_ltch_pct_positivity","num_ltch_tests","ltch_pct_positivity","observed_pct_positivity","pct_positivity_7_day","adjusted_new_episodes","adjusted_active_cases","adjusted_episode_cases"
"1",2020-03-01,7,7,0,0,0,2,0,0,2,0,0,1,1,0,0,2,NA,NA,NA,NA,NA,NA,NA,NA,2
"2",2020-03-02,10,10,0,0,0,3,2,0,1,0,0,1,1,0,0,3,NA,NA,NA,NA,NA,NA,NA,NA,3
"3",2020-03-03,11,11,0,0,0,1,0,0,1,0,0,1,1,0,0,1,NA,NA,NA,NA,NA,NA,NA,NA,1
"4",2020-03-04,12,12,0,0,0,1,0,0,1,0,0,1,1,0,0,1,NA,NA,NA,NA,NA,NA,NA,NA,1
"5",2020-03-05,18,17,0,0,0,6,2,0,4,0,0,1,1,0,0,6,NA,NA,NA,NA,NA,NA,NA,NA,6
"6",2020-03-06,23,22,0,0,0,5,0,1,4,0,0,1,1,0,0,4,NA,NA,NA,NA,NA,NA,NA,NA,5
"7",2020-03-07,27,26,0,0,0,4,0,0,4,0,0,1,1,0,0,4,NA,NA,NA,NA,NA,NA,NA,NA,4
"8",2020-03-08,36,35,0,0,0,9,1,0,8,0,0,1,1,0,0,9,NA,NA,NA,NA,NA,NA,NA,NA,9
"9",2020-03-09,45,44,0,1,0.1,9,0,0,9,0,0,1,1,0,0,9,NA,NA,NA,NA,NA,NA,NA,NA,9
"10",2020-03-10,52,51,0,0,0.1,7,1,0,6,0,0,1,1,0,0,7,NA,NA,NA,NA,NA,NA,NA,NA,7
"11",2020-03-11,61,60,0,0,0.1,9,0,0,9,0,0,1,1,0,0,9,NA,NA,NA,NA,NA,NA,NA,NA,9
"12",2020-03-12,75,74,0,3,0.6,14,1,0,13,0,0,1,1,0,0,14,NA,NA,NA,NA,NA,NA,NA,NA,14
"13",2020-03-13,97,96,0,1,0.7,22,2,2,18,0,0,1,1,0,0,20,NA,NA,NA,NA,NA,NA,NA,NA,22
"14",2020-03-14,115,114,0,4,1.3,18,1,1,16,1,0,2,2,0,1,17,NA,NA,NA,NA,NA,NA,NA,NA,18
"15",2020-03-15,142,140,0,4,1.9,27,1,0,26,0,0,2,2,0,1,27,NA,NA,NA,NA,NA,NA,NA,NA,27
"16",2020-03-16,157,155,0,0,1.7,15,0,0,15,0,0,2,2,0,1,15,NA,NA,NA,NA,NA,NA,NA,NA,15
"17",2020-03-17,180,177,0,5,2.4,23,1,0,22,2,0,4,4,0,3,23,127,0,4,0,0,0,23,177,23
"18",2020-03-18,196,192,0,4,3,16,0,0,16,0,0,3,3,0,3,16,210,0.0190499997138977,1,0,1.89597153550641,0.947985767753204,15.0278662196363,180.334394635636,16
"19",2020-03-19,221,217,0,1,2.7,25,0,0,25,4,0,7,7,0,7,25,110,0.0272699999809265,9,0,2.52075630075791,1.47224261208811,22.9804941802429,199.470689484508,25
"20",2020-03-20,243,239,0,2,2.9,22,1,1,20,3,1,10,9,0,10,21,137,0.00730000019073486,4,0,0.709290798674238,1.28150465873464,21.5226709570737,233.56754089241,22
"21",2020-03-21,263,259,0,4,2.9,20,0,2,18,3,1,10,9,0,13,18,204,0.0147099995613098,3,0,1.44968111618705,1.31513995022512,19.1637825504841,246.967760031966,20
"22",2020-03-22,289,284,0,7,3.3,26,0,1,25,3,5,13,8,0,16,25,159,0.0314499998092651,2,0,3.10593165818208,1.61360523488462,23.5116804993879,255.732690473047,26
"23",2020-03-23,310,305,0,9,4.6,21,2,0,19,4,5,17,12,0,20,21,138,0.0362299990653992,3,0,3.54591480214545,1.88964945877902,18.6137176430741,270.342089577981,21
"24",2020-03-24,328,321,1,8,5,18,1,3,14,3,7,20,13,1,23,15,253,0.0197599995136261,4,0,1.94524508830638,2.16754161425136,17.0649392544196,300.989700044579,18
"25",2020-03-25,351,344,1,8,5.6,23,0,1,22,4,8,23,15,0,27,22,153,0.0588199996948242,2,0,5.80610319568265,2.7261318514194,18.9066237035948,279.994479728937,23
"26",2020-03-26,365,354,1,19,8.1,14,1,3,10,2,7,25,18,0,29,11,274,0.025550000667572,3,0,2.5273285858898,2.72707074929538,13.1091006671737,325.329239652681,14
"27",2020-03-27,382,362,1,27,11.7,17,3,2,12,5,9,26,17,0,34,15,577,0.0294600009918213,4,0,2.92571782655437,3.04370318184968,15.5936353682622,328.05973355406,17
"28",2020-03-28,407,384,2,26,14.9,25,1,1,23,3,8,25,17,1,37,24,367,0.0817399978637695,3,0,8.10772411243336,3.99485218131344,18.764311058504,284.228976936064,25
"29",2020-03-29,426,396,2,11,15.4,19,5,4,10,7,8,31,23,0,44,15,184,0.0434800004959106,0,0,4.34800004959107,4.1722905229433,16.9099578800664,340.822888033753,19
"30",2020-03-30,451,406,3,48,21,25,8,3,14,4,12,32,20,1,48,22,549,0.0783199977874756,0,0,7.83199977874756,4.7845883767436,19.4783409513604,304.100292102379,25
"31",2020-03-31,468,403,3,51,27.1,17,2,3,12,6,13,34,21,0,54,14,943,0.064689998626709,0,0,6.4689998626709,5.43083905879567,14.0977192815598,319.455776462044,17
"32",2020-04-01,495,405,3,37,31.3,27,6,4,16,3,15,33,18,0,57,22,575,0.0573899984359741,4,0.25,5.87206374795943,5.44026199483521,21.8601206787453,328.788585222356,27
"33",2020-04-02,512,401,6,32,33.1,17,5,4,7,6,14,34,20,3,63,12,107,0.0841100025177002,9,0,7.75842264602924,6.1875611462837,13.0164802337621,301.300714478217,17
"34",2020-04-03,539,406,6,26,33,27,3,4,19,5,14,37,23,0,68,22,217,0.110600004196167,2,0,10.9589958495745,7.33517229242944,18.2737691130932,263.415920905265,27
"35",2020-04-04,556,414,7,18,31.9,17,3,7,6,7,14,43,29,1,75,9,315,0.0253999996185303,3,0,2.51603769806196,6.53635994751924,15.2743388172521,380.619585593597,17
"36",2020-04-05,583,425,8,40,36,27,4,8,13,4,13,43,30,1,79,17,422,0.0663500022888184,5,0.2,6.79149905524153,6.88543123404074,21.3001100635108,332.50275158777,27
"37",2020-04-06,602,425,9,40,34.9,19,3,7,9,4,12,44,32,1,83,12,238,0.117650003433228,4,0.25,11.9837606682265,7.47853993253773,14.3916165103719,261.786418075672,19
"38",2020-04-07,625,423,9,25,31.1,23,2,11,10,4,14,45,31,0,87,12,285,0.108769998550415,6,0,10.6527318167932,8.07621592598378,18.9034668011931,278.597204742058,23
"39",2020-04-08,645,426,11,26,29.6,20,1,10,8,5,16,44,28,2,92,9,368,0.0434800004959106,6,0.333330001831055,4.81300005173301,7.92492111223715,17.6118620906211,360.294805622731,20
"40",2020-04-09,681,434,11,25,28.6,36,1,20,13,6,16,47,31,0,98,14,295,0.0949199962615967,5,0,9.33379963239034,8.14997496743159,29.812442838469,304.18572799254,36
"41",2020-04-10,715,450,11,36,30,34,0,20,13,4,16,49,33,0,102,13,331,0.090629997253418,8,0,8.84912362562872,7.84856464972504,29.3134693102646,322.389322278391,34
"42",2020-04-11,759,480,11,31,31.9,44,0,34,8,5,19,53,34,0,107,8,225,0.102220001220703,11,0.363639984130859,11.4404830932617,9.12348542046786,39.0670234572723,304.021407436338,44
"43",2020-04-12,792,495,13,35,31.1,33,0,18,14,1,18,49,31,2,108,14,227,0.101319999694824,12,0.5,12.1337405567887,9.88666277783175,26.5562649546906,302.525082326559,33
"44",2020-04-13,816,502,16,16,27.7,24,0,19,5,3,20,51,31,3,111,5,165,0.0606099987030029,26,0.0384599995613098,5.75948155737672,8.99748004771035,23.0771573975311,409.346602712126,24
"45",2020-04-14,849,502,18,32,28.7,33,0,26,7,5,20,50,30,2,116,7,208,0.0673099994659424,18,0.166669998168945,7.52236276812258,8.55028446932883,31.3125669436929,380.98694367626,33
"46",2020-04-15,878,500,24,60,33.6,29,2,18,9,4,16,50,34,6,120,11,390,0.1,24,0.208330001831055,10.6280000106148,9.38099874916909,25.2535626860719,329.707394821451,29
"47",2020-04-16,948,549,24,21,33,70,1,55,13,7,13,52,39,0,127,14,310,0.0354800009727478,11,0,3.42641753942424,8.5370870216025,67.462756876008,488.718108923456,70
"48",2020-04-17,980,553,26,73,38.3,32,0,26,6,0,13,49,36,2,127,6,378,0.0846599960327148,66,0.5,14.6399726352176,9.36435116582949,29.1850819601386,293.55838732611,32
"49",2020-04-18,1020,575,31,31,38.3,40,0,31,9,1,11,46,35,5,128,9,421,0.0617600011825562,8,0,6.06082995288022,8.59582928863213,38.2519701372405,463.3203143237,40
"50",2020-04-19,1037,578,35,38,38.7,17,0,13,4,5,15,47,32,4,133,4,452,0.0442500019073486,47,0.127659997940063,5.21062540386865,7.60681283821498,16.3320805617252,481.485641169289,17
"51",2020-04-20,1098,614,39,16,38.7,61,1,47,13,3,13,45,32,4,136,14,325,0.0523099994659424,43,0.0232599997520447,4.89155701515467,7.48282361789754,58.8054302195683,517.75243962964,61
"52",2020-04-21,1134,627,47,51,41.4,36,0,26,10,2,11,43,32,8,138,10,543,0.069980001449585,25,0.36,8.27449661745152,7.59027131065882,33.3483523068883,460.741689641894,36
"53",2020-04-22,1175,644,54,35,37.9,41,1,31,9,4,9,45,36,7,142,10,656,0.0243899989128113,122,0.106560001373291,3.7275269221524,6.60448944087848,39.8054755931266,567.072628197353,41
"54",2020-04-23,1220,659,57,50,42,45,0,35,10,5,11,48,37,3,147,10,775,0.0361299991607666,105,0.0285700011253357,3.522795394063,6.61825770582687,43.8710839206496,584.604430370807,45
"55",2020-04-24,1261,666,65,38,37,41,0,36,5,7,10,48,38,8,154,5,517,0.0406199979782104,94,0.106379995346069,5.07369206501887,5.25164619579848,40.187041551785,557.713934697768,41
"56",2020-04-25,1362,738,78,53,40.1,101,0,95,6,4,9,48,39,13,158,6,557,0.0502699995040894,28,0.0357100009918213,4.95731106864081,5.09400064090713,100.046827155759,620.759740158351,101
"57",2020-04-26,1416,757,87,88,47.3,54,0,41,13,5,9,50,41,9,163,13,358,0.0502799987792969,81,0.0123500001430511,4.32815252268233,4.96793308645194,52.196898610557,652.004019091665,54
"58",2020-04-27,1477,781,95,87,57.4,61,0,54,7,8,11,56,45,8,171,7,269,0.0632000017166138,80,0.1,7.16355314090805,5.29250396155957,59.3930559129897,601.71095257785,61
"59",2020-04-28,1498,777,103,65,59.4,21,0,14,7,7,13,61,48,8,178,7,503,0.0616300010681152,11,0.272730007171631,6.61477054788909,5.05540023733637,19.5161600382135,612.293764241703,21
"60",2020-04-29,1523,766,111,29,58.6,25,0,17,8,7,13,62,49,8,185,8,668,0.0314400005340576,74,0.148649997711182,4.31294072606172,5.13903078075198,23.8942989665214,660.129126044424,25
"61",2020-04-30,1543,756,122,30,55.7,20,0,10,10,2,11,56,45,11,187,10,603,0.0414599990844727,6,0.333330001831055,4.43355656139956,5.26913951894292,18.5792211210141,648.589116748665,20
"62",2020-05-01,1566,740,135,42,56.3,23,0,16,7,6,11,57,46,13,193,7,516,0.031010000705719,55,0.0909099960327148,3.67797025323123,5.06975068868754,22.1749495767849,652.780383831551,23
"63",2020-05-02,1587,741,139,22,51.9,21,0,15,6,4,12,57,45,4,197,6,508,0.0511800003051758,28,0.0357100009918213,5.03718660126871,5.08116147906296,20.0314689933265,621.386420675827,21
"64",2020-05-03,1606,722,148,23,42.6,19,0,13,6,3,12,52,40,9,200,6,826,0.0205800008773804,231,0.0043299999833107,1.70286761786764,4.70612077837514,18.6725791163366,682.600353665834,19
"65",2020-05-04,1624,719,152,14,32.1,18,0,11,7,6,10,52,42,4,206,7,637,0.0109899997711182,24,0.125,1.51295459216373,3.89889241426881,17.6606106790904,684.139868323714,18
"66",2020-05-05,1649,719,156,29,27,25,0,24,1,3,9,50,41,4,209,1,923,0.0292499995231628,29,0.172409992218018,3.36109656871868,3.4340818458159,24.8922901975212,641.556652017772,25
"67",2020-05-06,1665,693,161,23,26.1,16,0,11,5,4,10,52,42,5,213,5,598,0.0167200005054474,149,0.0134200000762939,1.60617674881196,3.04740127763736,15.7426420562107,657.330188990809,16
"68",2020-05-07,1688,671,167,32,26.4,23,0,16,7,6,10,54,44,6,219,7,813,0.0356699991226196,234,0.0128199994564056,3.05631224063884,2.85065208895726,22.3144012773347,605.280465298794,23
"69",2020-05-08,1701,638,173,16,22.7,13,0,8,5,4,8,54,46,6,223,5,715,0.00978999972343445,127,0.0472399997711182,1.54386339349022,2.54577968042283,12.7526265345741,606.435145811653,13
"70",2020-05-09,1718,622,179,12,21.3,17,0,12,5,5,7,52,45,6,228,5,1100,0.0154499995708466,164,0.0304900002479553,1.74013920637626,2.0747729097239,16.7211772313406,587.314447578774,17
"71",2020-05-10,1730,553,185,25,21.6,12,0,8,4,3,6,53,47,6,231,4,907,0.0176400005817413,316,0.0126600003242493,1.6353262984548,2.06512414980778,11.7903771355644,524.019638991775,12
"72",2020-05-11,1750,534,188,14,21.6,20,0,14,6,1,6,52,46,3,232,6,517,0.00967000007629394,197,0.0152300000190735,1.12040616851561,2.00904580357234,19.7845725798599,514.826959607531,20
"73",2020-05-12,1773,517,193,13,19.3,23,0,17,6,4,7,52,45,5,236,6,835,0.0131700003147125,322,0.00310999989509583,1.03702422031165,1.67703546808562,22.8006049424911,499.818792544647,23
"74",2020-05-13,1794,499,195,21,19,21,0,15,6,2,8,48,40,2,238,6,1249,0.0144099998474121,224,0.0133899998664856,1.42548878340193,1.65122290159847,20.725912459538,476.205052884908,21
"75",2020-05-14,1808,471,198,25,18,14,0,10,4,2,7,46,39,3,240,4,1046,0.0267700004577637,127,0.0236199998855591,2.6428951802461,1.59216332154237,13.6612228039078,431.108985160148,14
"76",2020-05-15,1828,457,201,17,18.1,20,0,12,8,1,6,45,39,3,241,8,1163,0.012039999961853,137,0.0146000003814697,1.23097846214588,1.54746547420746,19.684416215238,438.972276295472,20
"77",2020-05-16,1844,437,207,19,19.1,16,0,6,10,1,5,43,38,6,242,10,967,0.0134399998188019,25,0.04,1.4109354662078,1.50043636846911,15.5478511930008,417.241097134136,16
"78",2020-05-17,1856,397,212,15,17.7,12,0,9,3,1,3,43,40,5,243,3,353,0.0254999995231628,10,0.1,2.7552341134095,1.66042319917693,11.7351170523632,361.94715659606,12
"79",2020-05-18,1871,389,213,26,19.4,15,0,8,7,2,2,44,42,1,245,7,376,0.0398900008201599,17,0.0588199996948242,4.07088557333133,2.08192025700774,14.0868099430151,338.252723976124,15
"80",2020-05-19,1883,352,219,23,20.9,12,0,8,4,0,2,41,39,6,245,4,359,0.0390000009536743,31,0.225809993743896,5.38490003805894,2.70304537382879,11.3097413208948,291.257236238743,12
"81",2020-05-20,1898,338,223,17,20.3,15,0,9,6,3,2,42,40,4,248,6,675,0.0296300005912781,36,0.0555600023269653,3.0942912071566,2.94144572007945,14.4050415013306,304.484004574959,15
"82",2020-05-21,1906,324,229,11,18.3,8,0,1,7,0,2,39,37,6,248,7,478,0.0209200000762939,36,0,1.94547860631683,2.8418147809467,7.56358593545247,303.800263298086,8
"83",2020-05-22,1913,308,233,7,16.9,7,0,3,4,1,2,37,35,4,249,4,514,0.00583999991416931,14,0,0.568515143159664,2.74717716394867,6.92712538598764,302.388654721048,7
"84",2020-05-23,1922,304,236,6,15,9,1,3,5,1,1,36,35,3,250,6,582,0.00859000027179718,43,0,0.799900825309753,2.65988650096323,8.84619812349595,296.207371590461,9
"85",2020-05-24,1931,300,237,8,14,9,0,3,6,1,2,37,35,1,251,6,332,0.0150600004196167,25,0.04,1.68064989896716,2.50637447032861,8.67685105449492,283.842552724746,9
"86",2020-05-25,1946,296,240,6,11.1,15,1,7,7,0,2,36,34,3,251,8,401,0.0174600005149841,8,0,1.71184846124906,2.16936916860257,14.5611364187492,279.762047493721,15
"87",2020-05-26,1952,286,243,16,10.1,6,0,2,4,1,2,36,34,3,252,4,1123,0.00800999999046326,41,0.0731699991226196,1.03051545990701,1.54731422886658,5.86790428139325,276.555156119617,6
"88",2020-05-27,1957,258,243,8,8.9,5,0,1,4,1,2,34,32,0,253,4,1150,0.00957000017166138,13,0.0769199991226196,1.03228376491871,1.25274173711831,4.86767761276932,249.465206023621,5
"89",2020-05-28,1961,233,244,4,7.9,4,0,2,2,1,1,31,30,1,254,2,1403,0.00284999996423721,88,0,0.268179071081476,1.01312751779898,3.98281185072517,230.997580609483,4
"90",2020-05-29,1968,223,247,7,7.9,7,0,3,4,2,1,32,31,3,256,4,1380,0.0065200001001358,37,0,0.634975309681539,1.0226218273021,6.91860624794751,218.462298323074,7
"91",2020-05-30,1971,205,248,15,9.1,3,1,1,1,0,1,31,30,1,256,2,1020,0.0127499997615814,119,0,1.1417910234252,1.07146328417574,2.92682026053656,197.499076704997,3
"92",2020-05-31,1975,190,249,10,9.4,4,0,1,3,3,1,34,33,1,259,3,1309,0.00535000026226044,11,0.0909099960327148,0.606300022701422,0.917984730423489,3.94171147330682,186.308393309432,4
"93",2020-06-01,1986,180,250,5,9.3,11,0,5,6,0,1,31,30,1,259,6,763,0.00130999997258186,20,0,0.127653892602805,0.691671220616882,10.9754551969393,179.263655908178,11
"94",2020-06-02,1989,161,251,8,8.1,3,0,1,2,0,1,26,25,1,259,2,858,0.0104900002479553,9,0,1.03811075118174,0.692756262227556,2.93346534282799,155.643960097653,3
"95",2020-06-03,1999,152,251,8,8.1,10,0,7,3,0,0,22,22,0,259,3,1110,0.00449999988079071,141,0,0.399280564962245,0.602327233662347,9.96161392875235,150.055105723452,10
"96",2020-06-04,2006,142,254,8,8.7,7,0,2,5,0,0,20,20,3,259,5,1430,0.00559000015258789,21,0,0.550909732474203,0.642717328147022,6.91172765010581,139.493065263005,7
"97",2020-06-05,2010,133,256,15,9.9,4,0,1,3,1,0,21,21,2,260,3,1366,0.00952000021934509,29,0,0.932209340474939,0.685179332546079,3.91037917369061,129.026810033617,4
"98",2020-06-06,2013,124,257,2,8,3,0,0,3,0,0,21,21,1,260,3,1404,0.000710000023245811,68,0,0.0677201109128478,0.5317406307586,2.99348951782152,123.730900069956,3
"99",2020-06-07,2014,116,258,4,7.1,1,0,0,1,0,0,20,20,1,260,1,870,0.00230000004172325,22,0,0.22432735832951,0.477173107276898,0.992811198678096,115.166099046659,1
"100",2020-06-08,2017,108,258,0,6.4,3,0,0,3,0,0,19,19,0,260,3,701,0.0014300000667572,12,0,0.140593274445554,0.479021590397291,2.98648363100188,107.513410716068,3
"101",2020-06-09,2027,105,259,3,5.7,10,0,3,7,0,0,18,18,1,260,7,1338,0.00224000006914139,10,0,0.222338285794598,0.362482666770557,9.95012458389771,104.251868758466,10
"102",2020-06-10,2037,103,259,7,5.6,10,0,4,6,0,0,17,17,0,260,6,1281,0.00233999997377396,12,0,0.231828303666236,0.338560915156841,9.95542493893939,102.234794785126,10
"103",2020-06-11,2044,102,260,5,5.1,7,0,2,5,0,0,16,16,1,260,5,1529,0.00326999992132187,6,0,0.325721816267175,0.306391212841551,6.94780954403441,100.935314698302,7
"104",2020-06-12,2048,105,260,10,4.4,4,0,2,2,0,0,16,16,0,260,2,1596,0.00814999997615814,13,0,0.808415162333648,0.288706330249938,3.9481870064275,102.279817837444,4
"105",2020-06-13,2051,103,260,6,5,3,0,3,0,0,0,16,16,0,260,0,1479,0.00270000010728836,23,0.0434800004959106,0.332446083228058,0.326524326294968,3,101.902681542644,3
"106",2020-06-14,2054,100,260,1,4.6,3,0,1,2,0,0,16,16,0,260,2,768,0,13,0,0,0.294477560819324,3,100,3
"107",2020-06-15,2059,98,260,2,4.9,5,0,2,3,0,0,14,14,0,260,3,720,0.00555999994277954,17,0,0.543175028331244,0.351989239945851,4.94778018975344,96.294152865279,5
"108",2020-06-16,2063,97,260,3,4.9,4,0,1,3,1,0,14,14,0,261,3,1250,0.000799999982118607,14,0,0.0791139222822989,0.331528616586951,3.99239413854842,96.7540771463991,4
"109",2020-06-17,2066,87,260,8,5,3,0,0,3,1,1,6,5,0,262,3,1098,0.0091100001335144,26,0,0.889927059305944,0.425542724535481,2.91444411148096,84.5188792329477,3
"110",2020-06-18,2068,73,260,2,4.6,2,0,0,2,0,1,6,5,0,262,2,1304,0.00230000004172325,122,0,0.210322584460527,0.409057119991674,1.98651999217166,72.5079797142656,2
"111",2020-06-19,2071,71,260,5,3.9,3,0,0,3,0,1,5,4,0,262,3,1875,0.0010700000077486,19,0,0.105926611115556,0.308701612674804,2.98981641783219,70.7589885553618,3
"112",2020-06-20,2077,71,261,1,3.1,6,0,0,6,1,1,5,4,1,263,6,1792,0.000560000017285347,158,0,0.0514625656910432,0.268561110169516,5.99010497436363,70.8829088633029,6
"113",2020-06-21,2083,75,261,1,3.1,6,0,0,6,0,1,4,3,0,263,6,1102,0.00363000005483627,86,0,0.336722227308887,0.316664285499357,5.93525633580803,74.1907041976004,6
"114",2020-06-22,2085,74,262,6,3.7,2,0,1,1,0,1,1,0,1,263,1,509,0.0039300000667572,10,0,0.385427752211834,0.294128960339441,1.98764857057457,73.0859942225185,2
"115",2020-06-23,2094,79,262,4,3.9,9,0,0,9,0,1,1,0,0,263,9,1255,0.00158999994397163,20,0,0.156505876837992,0.305184953847398,8.95486147136001,78.6037840263823,9
"116",2020-06-24,2096,73,263,3,3.1,2,0,0,2,1,1,2,1,1,264,2,1733,0.00289000004529953,24,0,0.285052366448724,0.218774283439223,1.98173040645601,72.3331598356444,2
"117",2020-06-25,2102,71,263,6,3.7,6,0,0,6,0,1,2,1,0,264,6,1796,0.00277999997138977,21,0.0476200008392334,0.32982388366758,0.235845897611659,5.93658272298408,70.2495622219783,6
"118",2020-06-26,2106,65,263,6,3.9,4,0,0,4,0,1,2,1,0,264,4,2028,0.00196999996900558,23,0,0.194790830674955,0.248540786120145,3.97503090855295,64.5942522639855,4
"119",2020-06-27,2109,67,263,3,4.1,3,0,0,3,0,1,1,0,0,264,3,1574,0.000640000030398369,80,0,0.0609044768952257,0.249889630577885,2.99414475986423,66.8692329703011,3
"120",2020-06-28,2111,66,263,2,4.3,2,0,0,2,0,1,1,0,0,264,2,880,0.00114000000059605,12,0,0.112466367771807,0.217853079215445,1.99279179874155,65.7621293584712,2
"121",2020-06-29,2115,67,263,1,3.6,4,0,0,4,2,1,3,2,0,266,4,854,0.00351000010967255,8,0,0.347742470262222,0.212469467508358,3.95542493704702,66.2533676955376,4
"122",2020-06-30,2118,66,263,10,4.4,3,0,0,3,0,1,3,2,0,266,3,1605,0.00435999989509583,11,0,0.433032167798812,0.251973223359904,2.95836911409094,65.0841205100006,3
"123",2020-07-01,2120,65,263,4,4.6,2,0,0,2,0,2,3,1,0,266,2,1601,0.00312000006437302,15,0,0.309103966773589,0.255409166263456,1.98018888983051,64.3561389194917,2
"124",2020-07-02,2126,64,263,4,4.3,6,0,1,5,0,1,3,2,0,266,5,1012,0.00197999998927116,12,0,0.195679686439689,0.236245709516614,5.96864621419735,63.5986715417261,6
"125",2020-07-03,2134,72,263,4,4,8,0,0,8,0,1,3,2,0,266,8,1334,0.00300000011920929,14,0,0.296884284794154,0.2508304886765,7.9238882977137,71.3149946794233,8
"126",2020-07-04,2137,72,263,4,4.1,3,0,0,3,0,1,3,2,0,266,3,1257,0.00317999988794327,40,0,0.308192741645697,0.286157383640853,2.97037093818994,71.2889025165586,3
"127",2020-07-05,2139,69,263,5,4.6,2,0,0,2,0,1,2,1,0,266,2,734,0.00272000014781952,47,0,0.255631255889824,0.306609510514855,1.98361606605681,68.4347542789598,2
"128",2020-07-06,2145,69,263,0,4.4,6,0,1,5,0,1,2,1,0,266,5,602,0,10,0,0,0.256932014763109,6,69,6
"129",2020-07-07,2152,70,263,6,3.9,7,0,1,6,0,1,1,0,0,266,6,1272,0.0039300000667572,21,0,0.386617175940848,0.250301301640543,6.9256627255943,69.1327317986001,7
"130",2020-07-08,2165,76,263,5,4,13,0,1,12,0,1,1,0,0,266,12,1684,0.00296999990940094,39,0,0.29027741424441,0.247611794136374,12.8883731342564,75.2930298502904,13
"131",2020-07-09,2173,80,263,5,4.1,8,0,0,8,1,0,2,2,0,267,8,1504,0.00266000002622604,41,0,0.258941102876632,0.256649139341652,7.93361572457263,79.3361572457263,8
"132",2020-07-10,2189,93,263,12,5.3,16,0,0,16,0,0,2,2,0,267,16,1900,0.00684000015258789,14,0.0714300012588501,0.73124453017455,0.318700602967423,15.6250642500817,90.8206859535998,16
"133",2020-07-11,2196,98,263,7,5.7,7,0,0,7,1,1,2,1,0,268,7,1571,0.00381999999284744,25,0,0.376016290022765,0.328389681307004,6.9156511940393,96.8191167165502,7
"134",2020-07-12,2219,118,263,9,6.3,23,0,2,21,1,1,3,2,0,269,21,1068,0.00842999994754791,13,0,0.832862159480219,0.410851238962775,22.4395115540519,114.850588732292,23
"135",2020-07-13,2242,136,263,6,7.1,23,0,2,21,0,0,3,3,0,269,21,808,0.00619000017642975,65,0,0.572911814725686,0.492695783923587,22.6144494631605,133.50310128523,23
"136",2020-07-14,2261,146,263,4,6.9,19,0,2,17,1,0,4,4,0,270,17,1406,0.00356000006198883,66,0,0.340038049399205,0.486041622989067,18.8147532162248,144.40905703346,19
"137",2020-07-15,2282,166,263,15,8.3,21,0,0,21,1,0,5,5,0,271,21,1404,0.00782999992370606,46,0,0.758159992612641,0.552881991327386,20.4897836200114,161.966860996281,21
"138",2020-07-16,2304,184,263,7,8.6,22,0,1,21,0,0,5,5,0,271,21,1695,0.00708000004291534,25,0.04,0.75584884143846,0.623868811121932,21.491338947643,179.543160303158,22
"139",2020-07-17,2334,211,263,17,9.3,30,0,0,29,0,1,5,4,0,271,29,1787,0.00726999998092651,21,0,0.718555860946664,0.622056144089377,28.3322209761504,206.141331929922,30
"140",2020-07-18,2360,230,263,16,10.6,26,0,0,24,2,1,6,5,0,273,24,1551,0.00708999991416931,81,0,0.673810653607635,0.664598196030073,23.4817690410901,225.033619977113,26
"141",2020-07-19,2378,248,263,28,13.3,18,0,0,18,0,1,6,5,0,273,18,2025,0.0212299990653992,22,0,2.10018310246377,0.845644045027723,16.7885544359729,231.308972228961,18
"142",2020-07-20,2408,273,263,47,19.1,30,0,0,27,2,3,8,5,0,275,27,1548,0.0148599994182587,35,0.0285700011253357,1.51631264301018,0.980415591925508,25.6880213756854,259.734438354152,30
"143",2020-07-21,2432,292,263,23,21.9,24,0,0,23,0,3,8,5,0,275,23,1428,0.0161099994182587,15,0,1.59425358068423,1.15958923925194,21.8249415333323,277.081866423175,24
"144",2020-07-22,2459,312,263,13,21.6,27,0,1,23,2,3,9,6,0,277,23,1771,0.00902999997138977,16,0,0.894914938406899,1.17912566007969,23.3403951616837,303.052316975883,27
"145",2020-07-23,2478,320,263,29,24.7,19,0,1,17,1,3,10,7,0,278,17,1667,0.0101999998092651,32,0,1.0007886805206,1.21411706566285,17.4547878255607,309.73718259879,19
"146",2020-07-24,2501,335,263,34,27.1,23,0,1,18,0,3,7,4,0,278,18,2036,0.0122800004482269,83,0,1.17989999587494,1.28002337065261,18.3194000016849,322.333277809136,23
"147",2020-07-25,2513,334,263,26,28.6,12,0,1,10,1,3,8,5,0,279,10,2126,0.00800000011920929,320,0,0.695339339878943,1.28309889726279,10.7771713444621,326.557522905033,12
"148",2020-07-26,2520,336,263,21,27.6,7,0,0,6,2,4,10,6,0,281,6,1816,0.0121099996566772,73,0,1.16420113163186,1.14938718714395,5.77615185157012,323.464503687927,7
"149",2020-07-27,2535,338,264,22,24,15,0,1,13,1,4,10,6,1,282,13,1601,0.00874000012874603,24,0,0.861091704992148,1.05578419599852,13.6412705787117,328.673035046505,15
"150",2020-07-28,2555,327,264,14,22.7,20,0,2,17,1,4,11,7,0,283,17,1488,0.00739000022411346,24,0,0.727269863325452,0.931929379232978,18.6037960947145,319.378901351272,20
"151",2020-07-29,2571,322,264,20,23.7,16,2,2,12,2,4,12,8,0,285,14,2254,0.00620999991893768,52,0,0.606996522865808,0.890798177012822,15.7276743945166,315.736511073883,16
"152",2020-07-30,2591,332,264,19,22.3,20,1,0,18,1,4,13,9,0,286,19,1891,0.00898999989032745,134,0,0.839510607042431,0.867758452230227,18.4888433353586,323.06820985995,20
"153",2020-07-31,2601,319,264,18,20,10,0,1,9,1,3,14,11,0,287,9,2129,0.00797999978065491,207,0,0.727286795077667,0.803099423544901,9.79024010796042,311.56517715993,10
"154",2020-08-01,2618,306,264,15,18.4,17,0,0,17,1,2,14,12,0,288,17,1629,0.00551999986171722,83,0.0120500004291534,0.583658283315251,0.787144986892945,16.6820331724673,300.276597104411,17
"155",2020-08-02,2626,291,264,2,15.7,8,0,0,8,0,2,14,12,0,288,8,1340,0.00149000003933907,11,0,0.147786828476266,0.641942943585003,7.96211215053494,289.621829475709,8
"156",2020-08-03,2635,277,264,10,14,9,0,1,7,0,1,13,12,0,288,7,1046,0.0114699995517731,47,0,1.09767790769942,0.675740972543185,7.75376646357986,267.25618720166,9
"157",2020-08-04,2647,265,264,20,14.9,12,0,1,11,1,1,12,11,0,289,11,1699,0.0058899998664856,12,0,0.584869069150148,0.655398001946712,11.7938299489802,260.033176043615,12
"158",2020-08-05,2656,245,264,12,13.7,9,1,0,8,1,1,13,12,0,290,9,1599,0.005,70,0,0.479029358897543,0.637116978522675,8.86184109585627,241.239007609421,9
"159",2020-08-06,2666,221,264,12,12.7,10,0,0,10,1,2,11,9,0,291,10,1639,0.00305000007152557,10,0,0.303150401287472,0.560494091986252,9.90285233055211,218.853036505202,10
"160",2020-08-07,2678,222,264,6,11,12,0,3,9,1,2,11,9,0,292,9,1689,0,39,0,0,0.456595978403728,12,222,12
"161",2020-08-08,2684,205,264,14,10.9,6,1,1,4,0,1,11,10,0,292,5,1518,0.00725000023841858,95,0,0.682300084433937,0.470687664277826,5.89067495410637,200.517673118361,6
"162",2020-08-09,2686,196,264,16,12.9,2,0,1,1,2,2,13,11,0,294,1,1589,0.00441000014543533,102,0,0.414399185753799,0.508775143888902,1.98672015113749,193.397149622947,2
"163",2020-08-10,2698,197,264,8,12.6,12,2,0,10,0,1,13,12,0,294,12,1384,0.00578000009059906,27,0,0.566939767922686,0.432955409635084,11.7819819722338,193.420870710839,12
"164",2020-08-11,2711,201,264,8,10.9,13,2,1,10,0,1,13,12,0,294,12,1460,0.00342000007629395,41,0,0.332658235269098,0.396925290509219,12.8720754893606,198.85726444679,13
"165",2020-08-12,2718,184,264,12,10.9,7,3,0,4,0,2,11,9,0,294,7,1486,0.00268999993801117,7,0,0.267738774808078,0.366740921353581,6.93994024577213,182.421286460296,7
"166",2020-08-13,2740,187,264,11,10.7,22,0,0,22,0,2,10,8,0,294,22,1689,0.00532999992370605,56,0,0.515895121555274,0.397133024248982,21.6362874046786,183.908442939768,22
"167",2020-08-14,2751,181,264,6,10.7,11,4,1,6,1,2,11,9,0,295,10,1882,0.00477999985218048,36,0,0.469028139822923,0.464137044223685,10.8496951002019,178.279481313654,11
"168",2020-08-15,2755,173,264,2,9,4,0,0,4,1,2,12,10,0,296,4,2044,0.00734000027179718,21,0,0.726535620123653,0.470456406465073,3.90686967001709,168.972113228239,4
"169",2020-08-16,2759,155,264,26,10.4,4,0,1,3,0,2,12,10,0,296,3,1196,0.00501999974250793,22,0,0.492932651234769,0.481675472962354,3.95261039596961,152.551537125096,4
"170",2020-08-17,2782,169,265,8,10.4,23,1,4,18,1,1,10,9,1,297,19,1358,0.00662999987602234,32,0,0.647736678535132,0.493217888764132,22.6056096047049,165.492001220796,23
"171",2020-08-18,2808,188,265,15,11.4,26,1,1,24,0,1,8,7,0,297,25,1888,0.00583000004291534,77,0.0519500017166138,0.76372469278389,0.554798811266246,25.3881413838753,183.398823206742,26
"172",2020-08-19,2832,197,265,23,13,24,4,3,15,2,1,8,7,0,299,19,1519,0.0118499994277954,25,0.04,1.23057960691847,0.692347501567731,21.2507313639977,189.231267300397,24
"173",2020-08-20,2849,205,266,24,14.9,17,1,0,16,3,0,7,7,1,302,17,1607,0.00995999991893768,103,0,0.936007009925898,0.752363485620677,16.4900797469985,198.850961654982,17
"174",2020-08-21,2870,212,266,16,16.3,21,3,2,16,0,0,7,7,0,302,19,1804,0.00721000015735626,116,0.00861999988555908,0.729518764093518,0.789576431945048,20.5558145720623,207.043825751432,21
"175",2020-08-22,2889,222,266,16,18.3,19,1,0,18,1,0,8,8,0,303,19,1864,0.00589999973773956,73,0,0.567764559171221,0.766894851808986,18.6543025949488,217.96079874098,19
"176",2020-08-23,2906,232,266,13,16.4,17,0,1,15,0,0,8,8,0,303,15,694,0.0172899997234344,5,0,1.71663230444399,0.941709087981732,15.1748312373952,219.237389805046,17
"177",2020-08-24,2925,248,266,19,18,19,2,0,17,1,1,9,8,0,304,19,1142,0.00962999999523163,58,0,0.91645499954621,0.980097419554743,18.4419938510219,240.716551318602,19
"178",2020-08-25,2939,250,266,23,19.1,14,0,1,13,4,2,12,10,0,308,13,1647,0.0145700001716614,73,0,1.3951622257399,1.0703027814056,13.4187776575464,238.822647260507,14
"179",2020-08-26,2957,258,266,15,18,18,1,4,13,0,2,12,10,0,308,14,1832,0.0049099999666214,41,0,0.480251998870817,0.96311312311308,17.784537618503,254.029336112412,18
"180",2020-08-27,2970,261,266,16,16.9,13,1,3,9,1,2,10,8,0,309,10,1469,0.00612999975681305,9,0,0.609267228874044,0.916436011534243,12.8047540392336,255.904080423998,13
"181",2020-08-28,2998,271,266,20,17.4,28,0,3,21,1,1,10,9,0,310,21,2137,0.00607999980449677,35,0,0.598202559033591,0.897676553668539,23.5974296360347,265.804925303114,28
"182",2020-08-29,3019,285,266,12,16.9,21,0,2,18,0,1,10,9,0,310,18,1790,0.00726000010967255,11,0.0909099960327148,0.777091068999096,0.927580340786807,19.551751689041,277.902735076483,21
"183",2020-08-30,3039,299,267,16,17.3,20,0,6,12,2,1,11,10,1,312,12,1402,0.00428000003099442,33,0,0.418157494317364,0.742083939340146,17.8391965472086,294.993313967948,20
"184",2020-08-31,3059,307,267,13,16.4,20,1,3,16,1,1,12,11,0,313,17,1353,0.00517000019550324,54,0,0.497157801315983,0.682184339592971,19.7291571226066,302.108896272955,20
"185",2020-09-01,3084,311,267,18,15.7,25,1,2,22,0,1,12,11,0,313,23,1361,0.0154299998283386,22,0.0909099960327148,1.6630693911127,0.720456791789084,23.7742202417735,294.425325877893,25
"186",2020-09-02,3120,321,267,15,15.7,36,1,9,26,0,1,10,9,0,313,27,1528,0.00261999994516373,51,0,0.253537676770752,0.688069031489075,35.7806283460637,318.39191478098,36
"187",2020-09-03,3142,322,267,24,16.9,22,1,4,17,1,1,9,8,0,314,18,1493,0.00938000023365021,133,0.00751999974250793,0.922785997207461,0.732857426965278,21.4677106955332,312.47793577565,22
"188",2020-09-04,3164,326,267,24,17.4,22,0,3,19,3,1,12,11,0,317,19,2705,0.00813000023365021,258,0.00774999976158142,0.809691210614641,0.763070091476856,21.5069996077056,317.541151163791,22
"189",2020-09-05,3189,333,267,17,18.1,25,1,11,13,2,1,14,13,0,319,14,2256,0.00398999989032745,164,0,0.371960320354493,0.705194270241913,24.8331220762549,329.030689385207,25
"190",2020-09-06,3210,335,267,26,19.6,21,1,3,16,1,1,15,14,0,320,17,1310,0.00611000001430511,192,0.03125,0.932363516560566,0.778652273419513,19.4920646584778,324.990685917062,21
"191",2020-09-07,3251,360,267,29,21.9,41,2,6,33,0,1,13,12,0,320,35,1290,0.0147300004959106,44,0,1.4244153403092,0.91111763613283,39.4023599996171,343.567131424633,41
"192",2020-09-08,3303,397,267,24,22.7,52,0,14,36,3,1,15,14,0,323,36,1097,0.0127600002288818,4,0,1.27136423715562,0.855159756996105,48.5332816328653,380.825355784653,52
"193",2020-09-09,3348,428,267,15,22.7,45,2,10,31,0,1,14,13,0,323,33,1587,0.0144900000095367,29,0,1.42299690687715,1.02222536129702,41.4951537342291,408.482599946972,45
"194",2020-09-10,3425,490,267,33,24,77,1,21,52,2,2,15,13,0,325,53,1959,0.0127600002288818,61,0,1.23746734892968,1.06717984011448,71.8982364436405,470.568601082714,77
"195",2020-09-11,3455,504,267,60,29.1,30,0,1,25,0,1,13,12,0,325,25,2314,0.0155599999427795,93,0.0752699995040894,1.78670335776785,1.20675300399351,24.5685812515447,475.142598031141,30
"196",2020-09-12,3504,529,269,47,33.4,49,0,4,42,1,0,13,13,2,326,42,1900,0.0168400001525879,26,0,1.66126688940379,1.39093965671484,43.764045618958,500.837622200685,49
"197",2020-09-13,3539,542,270,31,34.1,35,1,5,29,1,1,12,11,1,327,30,1199,0.0166799998283386,44,0,1.6089557356539,1.48759568801389,33.4531806723684,514.054130814122,35
"198",2020-09-14,3607,592,272,59,38.4,68,0,19,49,1,1,12,11,2,328,49,2394,0.0141999995708466,218,0.0412799978256226,1.6460121936674,1.51925238135077,65.4153403250977,560.77309127465,68
"199",2020-09-15,3680,641,273,41,40.9,73,0,15,55,1,1,12,11,1,329,55,2961,0.0121599996089935,28,0,1.20460886056306,1.5097158989804,67.8768387375826,616.255520559826,73
"200",2020-09-16,3757,681,274,41,44.6,77,0,7,67,1,0,12,12,1,330,67,1887,0.0190799999237061,162,0.00616999983787537,1.80592971350752,1.56442058564189,70.1225171527755,641.58856986627,77
"201",2020-09-17,3807,706,278,57,48,50,2,4,38,2,2,12,10,4,332,40,2512,0.0191100001335144,208,0.00481000006198883,1.80164707162801,1.6450176888845,41.6905745341858,665.23864052838,50
"202",2020-09-18,3895,774,278,47,46.1,88,1,6,78,0,2,12,10,0,332,79,2409,0.0128699994087219,281,0.0213499999046326,1.37558284568078,1.58628618715778,81.5175244054424,739.880555567245,88
"203",2020-09-19,3965,824,280,47,46.1,70,2,4,60,0,2,11,9,2,332,62,2101,0.0214199995994568,161,0,1.98954107685494,1.6331824996508,62.0470725949498,771.46431964901,70
"204",2020-09-20,4008,856,280,76,52.6,43,1,4,34,2,2,12,10,0,334,35,2847,0.0186199998855591,112,0,1.79152212484578,1.6592634123925,36.9906089697101,806.85603651634,43
"205",2020-09-21,4117,936,280,55,52,109,2,22,82,1,3,13,10,0,335,84,2949,0.0189900004863739,73,0,1.85312744653596,1.68885130565944,101.011628222846,880.415285911711,109
"206",2020-09-22,4226,1015,280,85,58.3,109,0,27,81,3,3,16,13,0,338,81,2507,0.0135599994659424,64,0.03125,1.4000357316654,1.71676943010263,104.365887414402,969.46142871133,109
"207",2020-09-23,4331,1073,281,67,62,105,0,25,75,2,3,17,14,1,340,75,1896,0.0168799996376038,7,0.571430015563965,1.89198578149472,1.7290631541008,95.4527024740819,1007.94333006253,105
"208",2020-09-24,4433,1128,282,38,59.3,102,2,19,75,2,3,19,16,1,342,77,2730,0.0128199994564056,55,0,1.25668217292594,1.65121102571479,92.8990810257932,1082.57355061162,102
"209",2020-09-25,4552,1191,284,57,60.7,119,5,16,86,3,3,21,18,2,345,91,3291,0.0133700001239777,59,0.0339000010490417,1.37315732745982,1.65086452311179,102.995614039792,1138.59094858673,119
"210",2020-09-26,4636,1237,286,76,64.9,84,3,14,65,3,4,22,18,2,348,68,3437,0.0299699997901916,12,0,2.98657260883992,1.79329759910965,75.4918698507288,1118.60945596105,84
"211",2020-09-27,4718,1267,287,109,69.6,82,2,12,64,2,4,23,19,1,350,66,2684,0.0331599998474121,13,0,3.30001629923819,2.00879676687999,71.0203401273868,1133.01168093029,82
"212",2020-09-28,4833,1337,288,86,74,115,3,11,97,6,4,28,24,1,356,100,3135,0.0258400011062622,192,0.0104200005531311,2.49501182970644,2.10049453590435,103.004477530906,1230.09986458821,115
"213",2020-09-29,4940,1368,291,58,70.1,107,5,18,74,4,3,28,25,3,360,79,2165,0.0263299989700317,79,0.0253200006484985,2.62944419881239,2.27612431692535,90.3432033713073,1252.72787610061,107
"214",2020-09-30,5023,1397,291,107,75.9,83,1,10,67,5,5,31,26,0,365,68,3170,0.0305999994277954,281,0.0142299997806549,2.92670611777675,2.42394150782278,71.6223267210108,1265.97632984194,83
"215",2020-10-01,5123,1432,293,105,85.4,100,2,11,78,3,5,30,25,2,368,80,3844,0.0226300001144409,120,0.00833000004291534,2.21971040476944,2.56151696951471,85.3093674491142,1330.13767733914,100
"216",2020-10-02,5219,1482,294,115,93.7,96,0,13,79,1,5,30,25,1,369,79,3362,0.021710000038147,197,0,2.05082945007727,2.65832727274577,86.8080455270874,1384.60156292587,96
"217",2020-10-03,5292,1494,295,65,92.1,73,2,6,64,5,6,32,26,1,374,66,3113,0.0301999998092651,485,0.0103100001811981,2.75188853513406,2.62480097650208,66.1796511771734,1362.24846755602,73
"218",2020-10-04,5350,1476,295,77,87.6,58,1,7,47,3,6,33,27,0,377,48,3118,0.0291899991035461,102,0,2.82653469580301,2.55716074743991,50.6521976078725,1342.30507644208,58
"219",2020-10-05,5428,1477,295,82,87,78,3,13,59,3,6,34,28,0,380,62,3821,0.0177999997138977,238,0.00839999973773956,1.72488294763206,2.447142335715,71.5729096254816,1395.35786317478,78
"220",2020-10-06,5504,1450,296,139,98.6,76,5,15,53,2,7,35,28,1,382,58,2158,0.0194599997997284,55,0,1.89763576899295,2.34259827431222,69.472921785731,1361.82304464328,76
"221",2020-10-07,5605,1464,296,174,108.1,101,12,22,63,3,10,37,27,0,385,75,2268,0.0313100004196167,76,0,3.02948297575472,2.35728068259479,89.7187822576673,1321.87062966967,101
"222",2020-10-08,5685,1423,296,85,105.3,80,5,14,55,2,9,37,28,0,387,60,2434,0.0271199989318848,182,0,2.52332100153698,2.40065362499015,69.1482547238505,1307.93277453399,80
"223",2020-10-09,5770,1426,296,97,102.7,85,5,19,59,2,9,38,29,0,389,64,2508,0.0207299995422363,247,0.00810000002384186,1.95976547578285,2.38764448580523,78.9806269557941,1336.44334435879,85
"224",2020-10-10,5835,1411,297,67,103,65,5,7,51,6,9,44,35,1,395,56,2628,0.0300600004196167,21,0,2.98216991705371,2.42054182607947,57.6482643789677,1276.15537569149,65
"225",2020-10-11,5899,1376,297,140,112,64,6,6,48,5,10,47,37,0,400,54,2660,0.0233100008964539,238,0.0168099999427795,2.2776184393012,2.34212521800778,56.0586140061777,1275.56764578705,64
"226",2020-10-12,5961,1348,297,63,109.3,62,2,14,43,3,10,47,37,0,403,45,1994,0.0150499999523163,237,0.0126600003242493,1.47961093598233,2.30708635920068,56.8662954401703,1284.08369451888,62
"227",2020-10-13,6046,1370,298,74,100,85,4,10,68,1,7,46,39,1,404,72,2117,0.0302300000190735,18,0,2.9975133508374,2.4642117280356,75.0837949363103,1238.39998698257,85
"228",2020-10-14,6113,1375,300,84,87.1,67,1,16,49,2,7,46,39,2,406,50,3004,0.0296300005912781,110,0.0363599991798401,2.98677333609447,2.45811035094128,61.2142885587753,1243.39293536632,67
"229",2020-10-15,6199,1402,300,107,90.3,86,3,25,52,5,8,50,42,0,411,55,2119,0.021710000038147,105,0.00952000021934509,2.11344829603708,2.39955710729843,76.2749804528496,1307.04586536173,86
"230",2020-10-16,6274,1423,301,78,87.6,75,2,10,59,4,8,48,40,1,415,61,3126,0.0214299988746643,280,0.0035699999332428,1.99617664308598,2.40475870262745,67.0978582316337,1331.97134858385,75
"231",2020-10-17,6321,1405,302,64,87.1,47,1,10,36,6,8,50,42,1,421,37,3037,0.0214000010490417,149,0,2.03991849296735,2.2701513563294,44.5812622761804,1313.15333778469,47
"232",2020-10-18,6378,1372,305,74,77.7,57,1,11,40,2,6,48,42,3,423,41,1144,0.0271000003814697,37,0.0540500020980835,2.79443272769098,2.34398196895651,48.3284304897448,1249.13674712024,57
"233",2020-10-19,6442,1350,307,69,78.6,64,1,6,57,3,6,47,41,2,426,58,1334,0.0374799990653992,27,0,3.67364575703472,2.65741551482114,57.1719057322286,1191.07021962946,64
"234",2020-10-20,6520,1354,309,46,74.6,78,3,14,57,4,5,46,41,2,430,60,1595,0.0250799989700317,48,0.0208299994468689,2.49558358677117,2.58571126281168,69.2015871658904,1245.71581704359,78
"235",2020-10-21,6608,1376,312,69,72.4,88,1,46,40,4,4,45,41,3,434,41,2258,0.0305599999427795,446,0.00897000014781952,2.69989274913919,2.54472832181807,83.4526453614471,1256.94731749637,88
"236",2020-10-22,6674,1363,312,88,69.7,66,2,24,36,2,3,45,42,0,436,38,2238,0.0268099999427795,87,0.0114900004863739,2.62367354469915,2.61761764305551,58.8050237674995,1248.40124723952,66
"237",2020-10-23,6753,1365,313,92,71.7,79,1,13,64,2,3,38,35,1,438,65,2768,0.0245700001716614,65,0.0153799998760223,2.4359145946735,2.68043735042515,72.9260094610781,1258.44619868264,79
"238",2020-10-24,6818,1358,317,63,71.6,65,2,17,41,2,3,38,35,4,440,43,2358,0.0211999988555908,191,0,1.96114544140773,2.6691840573452,57.2975821718544,1272.65387417159,65
"239",2020-10-25,6888,1339,319,69,70.9,70,1,24,42,3,3,40,37,2,443,43,1751,0.0308400011062622,77,0,2.95409419787008,2.69199283879936,62.9293193366551,1212.24089748328,70
"240",2020-10-26,6961,1298,320,77,72,73,1,16,51,4,3,41,38,1,447,52,995,0.0392000007629395,121,0.0165299999713898,3.67420526484435,2.69207276848645,61.8773279514338,1145.16868617233,73
"241",2020-10-27,7039,1268,322,61,74.1,78,0,15,60,1,3,33,30,2,448,60,1354,0.0288000011444092,116,0,2.65273479928776,2.71452294170311,69.8994228148213,1160.20780215322,78
"242",2020-10-28,7151,1275,325,94,77.7,112,2,69,38,2,2,31,29,3,450,40,1900,0.0405299997329712,166,0.01807000041008,3.87253724882471,2.88204358451532,104.036022159618,1116.77320633784,112
"243",2020-10-29,7215,1260,326,65,74.4,64,0,18,42,9,2,39,37,1,459,42,2190,0.0292199993133545,96,0,2.79929127280168,2.90713183138712,56.2323407363642,1146.97022209093,64
"244",2020-10-30,7265,1229,328,122,78.7,50,1,9,36,4,2,42,40,2,463,37,2789,0.0358599996566772,105,0.0571400022506714,3.66320799166528,3.0824594595288,41.6565228511902,1084.72612389494,50
"245",2020-10-31,7304,1159,329,83,81.6,39,0,5,32,2,2,41,39,1,465,32,2352,0.0276399993896484,322,0,2.43116224997955,3.1496047178962,34.506908828018,1068.70335411478,39
"246",2020-11-01,7354,1118,332,50,78.9,50,1,6,40,1,2,39,37,3,466,41,1714,0.0256699991226196,104,0,2.42015283257261,3.07332737999656,43.8201920689737,1031.29206666128,50
"247",2020-11-02,7418,1070,332,56,75.9,64,3,8,47,6,2,44,42,0,472,50,1030,0.0174800002574921,14,0.0714300012588501,1.82034677038704,2.80849045221695,55.0832556120817,1007.58167009855,64
"248",2020-11-03,7489,998,333,36,72.3,71,1,36,33,1,2,45,43,1,473,34,1456,0.0219799995422363,13,0,2.17854862719511,2.74074957048943,67.6263295992979,928.325792355862,71
"249",2020-11-04,7554,922,337,53,66.4,65,5,1,51,1,1,42,41,4,474,56,1466,0.0272900009155273,295,0.0033899998664856,2.32863096551825,2.52019153001707,52.8210908053438,853.197245045124,65
"250",2020-11-05,7601,879,337,45,63.6,47,0,6,34,5,2,45,43,0,479,34,2536,0.0240499997138977,41,0,2.36673648717286,2.45839798921296,37.4212866879649,812.332676432974,47
"251",2020-11-06,7674,872,341,79,57.4,73,1,12,57,4,3,47,44,4,483,58,2342,0.0234800004959106,116,0.0258599996566772,2.35923194148077,2.27211569632945,65.6149669398252,806.07329606082,73
"252",2020-11-07,7709,838,346,75,56.3,35,3,4,25,3,4,47,43,5,486,28,2499,0.0276099991798401,142,0,2.61254782091709,2.2980279207491,29.6557899744583,767.841142807001,35
"253",2020-11-08,7746,776,346,47,55.9,37,1,5,29,1,4,48,44,0,487,30,1176,0.0204099988937378,92,0.0108700001239777,1.97178223268467,2.23397497790797,33.1043662048554,726.966272498926,37
"254",2020-11-09,7816,744,350,31,52.3,70,3,24,41,7,4,47,43,4,494,44,711,0.0210999989509583,20,0.1,2.3258685710166,2.30619237799791,64.7204663932833,688.546068104609,70
"255",2020-11-10,7883,753,350,51,54.4,67,0,11,54,3,5,48,43,0,497,54,1374,0.0334800004959106,17,0,3.30708272332,2.46741153458718,59.2771408497622,673.197908516128,67
"256",2020-11-11,7940,753,353,78,58,57,0,6,49,2,5,47,42,3,499,49,2375,0.0261100006103516,241,0.0290499997138977,2.63808491516186,2.51161924167912,50.8575326930022,689.34126771083,57
"257",2020-11-12,7982,743,355,58,59.9,42,1,8,31,3,3,44,41,2,502,32,2318,0.0215700006484985,214,0.00467000007629395,2.01416435701211,2.4612517945133,37.9345288956218,695.04234279522,42
"258",2020-11-13,8020,719,357,81,60.1,38,1,7,26,0,3,37,34,2,502,27,2719,0.0217000007629395,200,0,2.02131901591067,2.41297851943186,32.2510682384532,672.426594942513,38
"259",2020-11-14,8041,696,357,51,56.7,21,3,2,14,3,3,38,35,0,505,17,1710,0.015789999961853,245,0.0163300001621246,1.58576726212221,2.26629558246116,18.1361017226069,660.630988172612,21
"260",2020-11-15,8071,652,360,29,54.1,30,1,1,25,0,2,36,34,3,505,26,984,0.0152400004863739,306,0.00653999984264374,1.31762794034426,2.17284496926967,25.9021566326266,624.469466325867,30
"261",2020-11-16,8115,613,363,11,51.3,44,0,3,39,3,2,34,32,3,508,39,735,0.0122399997711182,53,0,1.1416751055548,2.0036744742037,40.5731399540588,590.572686970206,44
"262",2020-11-17,8156,590,363,38,49.4,41,1,10,29,1,2,33,31,0,509,30,1828,0.020789999961853,38,0,2.03666237568421,1.82218585311287,38.0419916740045,551.492502922089,41
"263",2020-11-18,8197,583,363,66,47.7,41,3,6,30,1,2,33,31,0,510,33,2684,0.0204900002479553,20,0.05,2.07082694768906,1.74114900061676,36.8100611573876,544.311080447181,41
"264",2020-11-19,8217,567,364,53,47,20,2,1,17,0,2,31,29,1,510,19,2476,0.0121200001239777,187,0.0160399997234344,1.23952685900304,1.63048650090118,19.2452836096812,544.477674036275,20
"265",2020-11-20,8242,524,364,29,39.6,25,1,2,20,1,2,31,29,0,511,21,2643,0.00757000029087067,222,0.0225200009346008,0.872842966012306,1.46641849377284,22.4126058051644,509.343116281244,25
"266",2020-11-21,8271,494,365,27,36.1,29,4,4,19,2,2,32,30,1,513,23,1495,0.0187300002574921,71,0,1.7880811229215,1.49532047388702,25.6820792576324,465.693354490017,29
"267",2020-11-22,8298,480,368,26,35.7,27,3,4,19,3,4,32,28,3,516,22,1220,0.0147500002384186,36,0,1.4327229530948,1.51176261856567,24.9899121703736,457.961720080879,27
"268",2020-11-23,8338,462,370,20,37,40,2,10,25,1,3,27,24,2,517,27,922,0.0173500001430511,13,0,1.71087701945381,1.5930771776941,35.5196759463151,436.670010636947,40
"269",2020-11-24,8382,472,370,21,34.6,44,2,7,34,1,3,23,20,0,518,36,1403,0.00855000019073486,41,0.0975599956512451,1.10772923056108,1.46037244267651,41.7220603185198,455.244790842815,44
"270",2020-11-25,8437,480,371,38,30.6,55,4,10,39,2,2,23,21,1,520,43,2618,0.0122200000286102,72,0.0138900005817413,1.22646989281736,1.33975000626627,51.3099498721246,461.134324153949,55
"271",2020-11-26,8482,495,372,60,31.6,45,3,4,37,3,2,23,21,1,523,40,3059,0.0143799996376038,224,0.00446000009775162,1.37031553193196,1.35843410239897,42.243473077785,473.26297933759,45
"272",2020-11-27,8528,506,374,56,35.4,46,2,3,40,3,1,24,23,2,526,42,3154,0.0177600002288818,336,0.00298000007867813,1.63370546556817,1.46712874519267,42.8011414563373,479.50898992635,46
"273",2020-11-28,8573,509,375,60,40.1,45,2,3,40,2,1,25,24,1,528,42,2597,0.0119400000572205,191,0,1.11220158352229,1.3705745252785,43.5030508829493,490.858402367172,45
"274",2020-11-29,8618,523,377,23,39.7,45,0,4,38,5,1,28,27,2,533,38,898,0.0245000004768372,12,0,2.41769235474723,1.51128443980027,39.0558571867594,482.479297596715,45
"275",2020-11-30,8662,530,378,45,43.3,44,1,7,35,1,1,25,24,1,534,36,1135,0.0229099988937378,61,0,2.17415123280873,1.57746647027955,40.4917750138831,493.073354371056,44
"276",2020-12-01,8715,550,378,34,45.1,53,2,11,39,3,1,27,26,0,537,41,1906,0.0141700005531311,113,0.0176999998092651,1.43675686145195,1.62447041754967,50.1122634895148,524.67670534715,53
"277",2020-12-02,8757,564,379,50,46.9,42,1,5,34,6,1,31,30,1,543,35,2859,0.0101400005817413,81,0.0123500001430511,1.0200888324757,1.59498740892943,38.8558570828412,545.562954134927,42
"278",2020-12-03,8795,563,380,40,44,38,0,6,31,3,1,33,32,1,546,31,3327,0.0102199995517731,202,0,0.963500666158941,1.53687099953329,36.0428324822364,545.616602822552,38
"279",2020-12-04,8837,566,382,54,43.7,42,1,5,32,2,1,31,30,2,548,33,2994,0.0110199999809265,165,0.0121200001239777,1.10774548791865,1.46173385986907,36.828538099512,545.907653464357,42
"280",2020-12-05,8872,555,382,45,41.6,35,3,2,29,1,1,31,30,0,549,32,2277,0.0184500002861023,209,0,1.68988940673592,1.54426069175673,32.2670640918373,524.944392842803,35
"281",2020-12-06,8911,548,383,33,43,39,0,7,30,1,2,31,29,1,550,30,1397,0.0157500004768372,20,0,1.55276998349623,1.42070035300659,35.5071965818487,520.73145756177,39
"282",2020-12-07,8964,550,384,24,40,53,0,4,44,2,1,31,30,1,552,44,1068,0.0168499994277954,25,0.04,1.73795053878184,1.3583859681456,45.5494457125515,519.368071406894,53
"283",2020-12-08,9011,555,384,58,43.4,47,1,1,44,0,1,28,27,0,552,45,2367,0.01942999958992,69,0,1.88796424586785,1.4228441659193,43.2774208258137,521.42152351837,47
"284",2020-12-09,9066,566,386,39,41.9,55,2,3,48,1,3,25,22,2,553,50,2911,0.00962000012397766,167,0.00598999977111816,0.942305078709412,1.41173220109555,51.4901431448425,548.908420399618,55
"285",2020-12-10,9110,564,386,57,44.3,44,2,0,42,1,3,24,21,0,554,44,3091,0.0139100003242493,252,0.00397000014781952,1.3160709255012,1.46209938100158,42.1443066548178,540.213385302665,44
"286",2020-12-11,9149,548,386,49,43.6,39,6,2,30,1,2,24,22,0,555,36,3047,0.0118099999427795,32,0,1.16872587936503,1.47081086549392,36.6516911021145,527.475742332187,39
"287",2020-12-12,9178,533,387,56,45.1,29,2,5,22,0,2,21,19,1,555,24,2616,0.0156700003147125,24,0,1.5527545766397,1.45122017548018,27.8057691149652,506.478122428185,29
"288",2020-12-13,9218,531,388,28,44.4,40,5,2,33,0,2,20,18,1,555,38,1502,0.0119799995422363,47,0,1.16165005244926,1.39534589961632,38.5854016344538,511.23284915513,40
"289",2020-12-14,9260,528,388,19,43.7,42,3,4,35,2,2,21,19,0,557,38,917,0.0174500000476837,20,0,1.70775347318313,1.39103203310222,39.9203846573008,499.104292080391,42
"290",2020-12-15,9308,538,389,51,42.7,48,2,7,38,1,1,21,20,1,558,40,2079,0.0134700000286102,49,0,1.31598355542672,1.30932050589635,45.3131180443965,515.311437697133,48
"291",2020-12-16,9362,554,389,53,44.7,54,3,4,46,0,1,19,18,0,558,49,2312,0.0168700003623962,94,0,1.62109064164007,1.4062898720293,50.4544735288545,525.21996602011,54
"292",2020-12-17,9399,549,390,61,45.3,37,1,5,29,2,0,19,19,1,560,30,3207,0.0134099996089935,83,0.0241000008583069,1.36796865706023,1.41370383368059,33.6848610490362,524.932957197362,37
"293",2020-12-18,9441,539,390,23,41.6,42,3,4,35,0,0,18,18,0,560,38,3298,0.00727999985218048,170,0.00587999999523163,0.72113724082124,1.34976259960291,41.1218357369766,526.543933216588,42
"294",2020-12-19,9480,536,390,46,40.1,39,1,7,29,3,0,21,21,0,563,30,2799,0.0117900002002716,140,0,1.12283805922287,1.28834595425765,35.9205249260009,516.713378677882,39
"295",2020-12-20,9524,531,390,24,39.6,44,5,2,34,0,0,18,18,0,563,39,1360,0.0161800003051758,51,0,1.55951810170369,1.34518424700828,39.0509217907824,504.462550536037,44
"296",2020-12-21,9599,552,390,28,40.9,75,7,8,59,1,0,17,17,0,564,66,1365,0.00658999979496002,32,0.03125,0.715486737302823,1.20343185616824,72.4867183623026,539.34346266653,75
"297",2020-12-22,9680,593,390,66,43,81,5,7,67,2,0,17,17,0,566,72,3021,0.0225099992752075,48,0,2.21579367254487,1.33197615861369,73.8874678360098,550.892617038247,81
"298",2020-12-23,9782,662,390,52,42.9,102,5,6,90,1,1,15,14,0,567,95,2652,0.0199800002574921,199,0.0150800001621246,1.96379799070964,1.38093435133791,95.021466658432,620.339062398758,102
"299",2020-12-24,9855,690,390,57,42.3,73,11,5,55,2,1,15,14,0,569,66,3469,0.01557000041008,144,0,1.49494413015686,1.39907370463743,67.8381363572467,656.944152825761,73
"300",2020-12-25,9919,720,390,52,46.4,64,6,2,55,0,1,12,11,0,569,61,2537,0.0295600008964539,161,0,2.77960423551903,1.69314041816568,57.5664078254224,655.865797283674,64
"301",2020-12-26,10012,762,390,86,52.1,93,5,4,83,2,2,14,12,0,571,88,951,0.0199800002574921,50,0,1.89819982466283,1.80390638465711,86.6469803196794,715.647715949951,93
"302",2020-12-27,10123,827,391,35,53.7,111,8,6,95,2,4,14,10,1,573,103,1480,0.0270300006866455,32,0.0625,2.77806885028012,1.97798506302517,99.8303139094977,753.375433040336,111
"303",2020-12-28,10258,924,391,65,59,135,15,7,111,1,2,14,12,0,574,126,1188,0.04125,39,0.0256399989128113,4.07538385962507,2.45797036621406,116.544415794695,803.325715827761,135
"304",2020-12-29,10378,1000,391,113,65.7,120,5,15,100,3,4,13,9,0,577,105,1880,0.0505299997329712,25,0.04,5.03918107600976,2.8613114238519,103.043996308426,838.514250556441,120
"305",2020-12-30,10515,1091,391,88,70.9,137,12,10,115,3,5,14,9,0,580,127,2458,0.0573600006103516,62,0,5.59487625000969,3.38003688946619,114.229716124031,895.39071095526,137
"306",2020-12-31,10640,1178,391,147,83.7,125,0,9,116,2,5,14,9,0,582,116,2652,0.0331800007820129,144,0,3.14711595400209,3.6160614357298,113.301101506924,1059.19566875135,125
"307",2021-01-01,10757,1233,392,89,89,117,0,5,111,2,6,14,8,1,584,111,2759,0.0391400003433228,134,0.0149300003051758,3.80186246070242,3.76209832504171,102.476359443512,1082.77793868333,117
"308",2021-01-02,10869,1291,392,134,95.9,112,4,8,100,2,6,16,10,0,586,104,2369,0.0295499992370605,431,0,2.50014100687844,3.84808992250108,103.667562176368,1187.56560355472,112
"309",2021-01-03,10992,1317,393,107,106.1,123,0,5,118,3,5,19,14,1,589,118,1516,0.0600299978256226,126,0.0238100004196167,5.72506313986087,4.26908910672691,101.3510654725,1075.37587480748,123
"310",2021-01-04,11168,1428,393,115,113.3,176,5,30,141,5,8,22,14,0,594,146,1386,0.0533900022506714,155,0.00644999980926514,4.86685873393035,4.38215694591337,153.229328642577,1205.28411850411,176
"311",2021-01-05,11311,1504,395,105,112.1,143,2,19,122,6,8,24,16,2,600,124,2417,0.0575099992752075,97,0.0103100001811981,5.56888378145397,4.45782876097683,120.870883319436,1235.59522993897,143
"312",2021-01-06,11495,1600,395,132,118.4,184,11,42,130,7,7,29,22,0,607,141,2627,0.0513899993896484,211,0.0142200005054474,4.86264793880394,4.35322471651887,161.028172591634,1350.67429891216,184
"313",2021-01-07,11610,1632,395,188,124.3,115,2,7,105,6,9,33,24,0,613,107,2311,0.048899998664856,91,0.0109899997711182,4.74637747267502,4.58169064775786,97.7250264759577,1383.76862811928,115
"314",2021-01-08,11743,1664,395,186,138.1,133,6,13,113,0,11,31,20,0,613,119,2661,0.0368300008773804,249,0,3.36785678126148,4.51968983640915,119.156753585887,1484.41040308332,133
"315",2021-01-09,11843,1675,397,153,140.9,100,6,2,92,4,11,31,20,2,617,98,3020,0.0324499988555908,375,0.00266999989748001,2.91606027998348,4.57910687542416,90.8420807035885,1518.47433855623,100
"316",2021-01-10,11935,1659,397,120,142.7,92,5,3,82,5,11,35,24,0,622,87,1824,0.0509899997711182,78,0,4.88989272252994,4.45979681580545,76.3669564200138,1399.03196207819,92
"317",2021-01-11,12099,1710,397,66,135.7,164,2,25,135,3,13,35,22,0,625,137,1608,0.0342000007629395,115,0,3.1917354165297,4.22049348474822,147.987304368598,1535.09701073213,164
"318",2021-01-12,12240,1738,398,160,143.6,141,1,22,116,4,13,36,23,1,629,117,2211,0.0705600023269653,74,0.0135099995136261,6.87124311198813,4.40654481768167,113.237060399911,1355.29923910295,141
"319",2021-01-13,12329,1726,402,172,149.3,89,1,9,76,2,11,35,24,4,631,77,2532,0.0375200009346008,173,0.0115600001811981,3.58597125315181,4.22416243401708,77.1514569559236,1527.65473644057,89
"320",2021-01-14,12420,1712,402,130,141,91,2,14,74,9,10,42,32,0,640,76,2581,0.0337100005149841,146,0,3.19052113418313,4.00189724280395,82.229491192911,1536.95906476663,91
"321",2021-01-15,12515,1680,404,144,135,95,6,7,80,5,11,42,31,2,645,86,2923,0.0372900009155273,206,0.00485000014305115,3.51542897748658,4.02297898512182,83.3116232567433,1490.73868687592,95
"322",2021-01-16,12576,1631,405,119,130.1,61,0,1,58,2,9,40,31,1,647,58,2470,0.0323900008201599,289,0,2.89972098679938,4.02064480038124,53.6103762971193,1479.44006449313,61
"323",2021-01-17,12655,1570,407,74,123.6,79,2,3,71,2,9,40,31,2,649,73,2036,0.026029999256134,32,0,2.5627213967838,3.68819175384607,70.004871530381,1441.06367537943,79
"324",2021-01-18,12777,1592,408,64,123.3,122,2,45,73,7,10,44,34,1,656,75,1021,0.0391799998283386,48,0,3.74207481990026,3.7668116686133,111.006101770548,1401.08952024951,122
"325",2021-01-19,12851,1533,415,81,112,74,3,24,47,8,9,46,37,7,664,50,2337,0.0410799980163574,89,0,3.95729412053699,3.35053324126313,67.6592216355764,1338.59173534677,74
"326",2021-01-20,12912,1491,415,166,111.1,61,1,8,50,2,7,38,31,0,666,51,3065,0.0225099992752075,163,0.00612999975681305,2.16828803404187,3.14800706710457,55.4562637741796,1387.39782916278,61
"327",2021-01-21,12983,1460,417,81,104.1,71,1,9,60,3,7,38,31,2,669,61,2636,0.0242799997329712,117,0,2.32481217929938,3.02433435926404,65.4554389062351,1351.22853775579,71
"328",2021-01-22,13061,1428,418,94,97,78,1,3,73,5,6,38,32,1,674,74,2311,0.0307200002670288,111,0.00901000022888184,2.97250332958338,2.94677355242072,69.950987049503,1291.97310144176,78
"329",2021-01-23,13110,1364,418,84,92,49,1,4,41,4,9,40,31,0,678,42,2122,0.0329900002479553,276,0,2.91929860409346,2.9495703548913,42.0708188762281,1236.39516540893,49
"330",2021-01-24,13156,1280,419,44,87.7,46,2,9,35,2,8,38,30,1,680,37,1247,0.0224499988555908,36,0,2.18200690357925,2.8951825701478,43.4127876042514,1190.49643603897,46
"331",2021-01-25,13219,1222,419,29,82.7,63,1,18,43,4,7,39,32,0,684,44,825,0.0206100010871887,48,0,1.94768051511234,2.63884052660667,59.253721132804,1145.72834600651,63
"332",2021-01-26,13281,1158,420,74,81.7,62,1,19,40,8,5,41,36,1,692,41,2354,0.024210000038147,79,0,2.3423896461076,2.40813988740247,56.9223641275872,1071.07555267673,62
"333",2021-01-27,13359,1118,422,80,69.4,78,0,27,50,1,4,31,27,2,693,50,2800,0.0196399998664856,175,0.00570999979972839,1.88205880978528,2.36724999822296,73.9843743178635,1050.57060974743,78
"334",2021-01-28,13397,1057,422,66,67.3,38,1,3,33,3,5,31,26,0,696,34,2355,0.0212299990653992,209,0.0287100005149841,2.18397183723271,2.34712994935629,34.6204206592897,983.023077554977,38
"335",2021-01-29,13424,951,422,73,64.3,27,1,2,24,3,4,32,28,0,699,25,2847,0.0122899997234344,180,0.00555999994277954,1.18898015204223,2.09234092399327,26.047447650571,914.76490862772,27
"336",2021-01-30,13443,854,423,41,58.1,19,1,6,12,2,5,34,29,1,701,13,2155,0.0157799994945526,216,0,1.43424288953019,1.88019010762709,18.4024967157793,814.748630405812,19
"337",2021-01-31,13485,795,424,25,55.4,42,3,5,34,4,6,33,27,1,705,37,922,0.0195200002193451,24,0,1.90247782264653,1.84025738177955,39.7442261079404,746.531344751693,42
"338",2021-02-01,13529,708,424,27,55.1,44,6,7,29,4,5,30,25,0,709,35,548,0.0292000007629395,29,0,2.77324097367259,1.9581945901453,38.8895022506017,645.079074097887,44
"339",2021-02-02,13572,646,425,59,53,43,4,5,32,3,5,28,23,1,712,36,2439,0.0221399998664856,107,0.0280399990081787,2.23879574109322,1.94339546085754,38.4171974185219,599.653042565699,43
"340",2021-02-03,13635,631,425,54,49.3,63,4,22,36,2,4,27,23,0,714,40,2865,0.0129100000858307,212,0,1.20205233168362,1.84625167827158,60.4591597823191,606.693245566084,63
"341",2021-02-04,13717,633,425,51,47.1,82,3,43,33,2,5,26,21,0,716,36,2814,0.0127900004386902,90,0,1.23936161275738,1.71130736048939,77.5702016874253,607.859379670561,82
"342",2021-02-05,13773,630,427,72,47,56,1,8,46,2,5,22,17,2,718,47,2435,0.0160199999809265,149,0,1.50962461120573,1.75711371179847,52.7262586265573,599.522190100661,56
"343",2021-02-06,13798,599,427,61,49.9,25,1,4,19,3,6,22,16,0,721,20,2369,0.0143499994277954,205,0.0146300005912781,1.43722994427581,1.75754043390498,23.0788497131844,571.411548909873,25
"344",2021-02-07,13823,554,429,33,51,25,1,2,19,3,4,24,20,2,724,20,1004,0.0249000000953674,75,0,2.31692308579693,1.81674690006933,20.5150362518456,512.866504176124,25
"345",2021-02-08,13871,552,431,24,50.6,48,1,7,39,2,5,22,17,2,726,40,852,0.0140799999237061,29,0,1.36165266004513,1.61509142669397,45.2545775039835,527.913169554972,48
"346",2021-02-09,13926,572,431,42,48.1,55,5,8,39,0,2,19,17,0,726,44,2244,0.0178299999237061,149,0,1.67198160588368,1.5341179788069,49.642463579139,541.352026528806,55
"347",2021-02-10,13981,587,432,41,46.3,55,0,5,49,3,4,20,16,1,729,49,2791,0.0125399994850159,100,0,1.21062395581734,1.53534249654028,52.0990110935326,564.22692881436,55
"348",2021-02-11,14039,611,433,51,46.3,58,1,11,44,1,3,17,14,1,730,45,2563,0.0152199995517731,58,0,1.48831968146488,1.57090793492707,53.8537368076983,581.858515322304,58
"349",2021-02-12,14090,614,435,52,43.4,51,0,8,42,3,2,17,15,2,733,42,2612,0.0157000005245209,173,0,1.47247401687786,1.56560070716595,48.0181482277118,585.027214567025,51
"350",2021-02-13,14125,615,435,45,41.1,35,0,4,30,6,2,21,19,0,739,30,2099,0.0219199991226196,46,0.0217400002479553,2.19161390068926,1.67336984379644,31.8930242360492,571.80699683901,35
"351",2021-02-14,14165,588,437,49,43.4,40,0,4,34,4,2,21,19,2,743,34,1175,0.0170200002193451,10,0,1.6876371525511,1.58347185333275,36.1612095749759,556.199742061348,40
"352",2021-02-15,14226,609,438,34,44.9,61,2,8,50,4,2,23,21,1,747,52,867,0.0265300011634827,26,0,2.57575711184093,1.75691534644643,55.7077748966667,558.731440616732,61
"353",2021-02-16,14279,606,438,61,47.6,53,3,13,34,3,2,24,22,0,750,37,1561,0.0333100008964539,23,0,3.28263329541442,1.98700844495083,46.1077714563314,542.25160817667,53
"354",2021-02-17,14336,622,439,50,48.9,57,5,6,43,2,2,25,23,1,752,48,2063,0.0184200000762939,222,0,1.66303983183345,2.0516392843817,51.4418964077161,588.851240949988,57
"355",2021-02-18,14408,639,439,68,51.3,72,3,12,53,3,3,26,23,0,755,56,2348,0.0212899994850159,116,0,2.02877105482213,2.12884662343274,64.3592127132253,597.456016495554,72
"356",2021-02-19,14463,645,440,58,52.1,55,2,16,34,1,3,26,23,1,756,36,2576,0.0151400005817413,96,0,1.45960484650321,2.12700817052207,50.3161165191222,614.830420967606,55
"357",2021-02-20,14512,625,440,66,55.1,49,0,3,45,4,3,26,23,0,760,45,2384,0.0255900001525879,68,0,2.48803264126303,2.16935370488975,44.4120793767021,575.167769120862,49
"358",2021-02-21,14552,611,440,53,55.7,40,0,7,32,2,4,24,20,0,762,32,1000,0.03,28,0,2.91828793774319,2.34516095991719,36.0073746024354,553.85955881525,40
"359",2021-02-22,14617,628,440,32,55.4,65,0,11,53,1,6,23,17,0,763,53,863,0.0150600004196167,66,0,1.39900757396439,2.17705388307769,61.6238701275048,599.845102642887,65
"360",2021-02-23,14670,632,440,47,53.4,53,0,7,45,3,6,25,19,0,766,45,2036,0.019650000333786,84,0,1.88714154149001,1.97769791823135,49.2786072242376,593.779550349293,53
"361",2021-02-24,14720,641,441,60,54.9,50,2,10,38,1,6,24,18,1,767,40,2874,0.0187899994850159,41,0,1.85257147581254,2.00477386737122,47.6252975342078,602.945392985679,50
"362",2021-02-25,14753,636,441,44,51.4,33,1,5,25,1,6,23,17,0,768,26,2376,0.0185199999809265,128,0.00781000018119812,1.79725239528254,1.97169977315127,29.5025350774351,599.369704201875,33
"363",2021-02-26,14819,639,441,57,51.3,66,5,12,44,1,6,21,15,0,769,49,2639,0.0181900000572205,181,0,1.70224858691506,2.00636316463868,58.3270348201638,604.142352042544,66
"364",2021-02-27,14864,642,442,71,52,45,0,5,32,3,6,23,17,1,772,32,2535,0.0209100008010864,47,0.0212800002098083,2.09167358794017,1.94974044273542,34.8550452744133,598.966845817917,45
"365",2021-02-28,14930,656,442,50,51.6,66,2,9,54,7,6,28,22,0,779,56,1552,0.0257699990272522,94,0,2.42983222905804,1.87996105578039,60.6394772749134,604.9195909347,66
"366",2021-03-01,15006,668,442,55,54.9,76,3,6,65,3,6,29,23,0,782,68,996,0.0291199994087219,45,0,2.78612098089213,2.07812011391293,67.9286800188312,608.358209596754,76
"367",2021-03-02,15073,679,443,62,57,67,1,7,58,3,4,29,25,1,785,59,2006,0.0259200000762939,41,0,2.54008403287961,2.17139761268287,61.1974230171115,623.729664891842,67
"368",2021-03-03,15134,691,443,65,57.7,61,1,5,51,6,5,32,27,0,791,52,2676,0.0209299993515015,109,0,2.01108360016581,2.19404220187619,53.648743208802,646.466953024657,61
"369",2021-03-04,15188,683,443,61,60.1,54,2,3,49,1,5,31,26,0,792,51,2414,0.0202999997138977,225,0.00444000005722046,1.89477829944008,2.2079744738987,50.9032737375266,641.528156131974,54
"370",2021-03-05,15261,686,444,51,59.3,73,2,9,57,2,2,28,26,1,794,59,2440,0.0188499999046326,154,0,1.77309174122218,2.218094924514,64.6475874519436,647.021101559886,73
"371",2021-03-06,15315,698,445,46,55.7,54,3,3,46,0,2,26,24,1,794,49,1956,0.0209599995613098,25,0,2.06954866945593,2.2149342218734,48.7502798510426,651.708068082199,54
"372",2021-03-07,15355,689,446,55,56.4,40,0,0,38,2,5,25,20,1,796,38,1748,0.0188800001144409,16,0.0625,1.92756463719063,2.14318170874948,35.6527097988715,646.439922405854,40
"373",2021-03-08,15440,733,447,39,54.1,85,2,10,66,6,4,29,25,1,802,68,1171,0.0204999995231628,142,0,1.82829394071772,2.00634927443885,74.015909714669,690.053850306652,85
"374",2021-03-09,15497,739,447,70,55.3,57,0,8,46,1,3,27,24,0,803,46,2097,0.031470000743866,57,0,3.06372291364378,2.08115482883373,49.4837127633661,666.444863741904,57
"375",2021-03-10,15575,760,447,77,57,78,3,7,65,0,2,24,22,0,803,68,2655,0.0180799996852875,175,0,1.69619785033351,2.03617115028626,71.3037642760768,718.689130144388,78
"376",2021-03-11,15635,757,450,73,58.7,60,1,6,50,1,2,20,18,3,804,51,2320,0.0284500002861023,86,0,2.74330842326506,2.15738973940412,52.5164806125869,690.450506347613,60
"377",2021-03-12,15705,750,450,97,65.3,70,2,4,60,2,2,17,15,0,806,62,2362,0.0237100005149841,133,0,2.24461006879329,2.2247495004857,61.5402877790236,696.05186829464,70
"378",2021-03-13,15761,756,450,56,66.7,56,4,4,42,4,4,21,17,0,810,46,2353,0.0187000000476837,99,0,1.79449837325448,2.18545660102835,47.3546987349288,712.525048774047,56
"379",2021-03-14,15810,761,450,65,68.1,49,1,6,39,2,3,22,19,0,812,40,1542,0.0343700003623962,36,0,3.35858938902503,2.38988870843327,41.6948217071067,679.093982977706,49
"380",2021-03-15,15892,782,451,59,71,82,0,3,75,4,5,24,19,1,816,75,1002,0.0349300003051758,13,0,3.44826209909223,2.6213127310582,69.7122666220401,695.586566645805,82
"381",2021-03-16,15966,785,452,85,73.1,74,2,6,63,5,6,26,20,1,821,65,1583,0.0334800004959106,9,0,3.32907291363232,2.6592198739137,64.0655678552573,701.2533964058,74
"382",2021-03-17,16038,796,453,78,73.3,72,2,4,62,3,5,26,21,1,824,64,2855,0.0322199988365173,175,0,3.03591078146063,2.85060743550329,61.7735111111994,718.558044445543,72
"383",2021-03-18,16137,839,454,63,71.9,99,3,4,90,2,5,23,18,1,826,93,2576,0.0322199988365173,161,0,3.03247047873104,2.89191630056986,87.962386401694,757.467120333562,99
"384",2021-03-19,16247,872,456,118,74.9,110,7,4,92,2,4,23,19,2,828,99,2617,0.0405000019073486,96,0,3.90669019504354,3.12935631860561,90.6058026764724,762.83090842307,110
"385",2021-03-20,16322,896,457,83,78.7,75,3,4,65,5,5,27,22,1,833,68,2018,0.0545100021362305,149,0.00671000003814697,5.12233384017522,3.60476138530857,60.8377683498457,748.921182962673,75
"386",2021-03-21,16385,902,458,88,82,63,7,3,52,2,5,27,22,1,835,59,1311,0.045770001411438,87,0,4.29216536841167,3.73812938236381,53.884735174798,777.932730977421,61
"387",2021-03-22,16538,982,459,56,81.6,153,4,6,138,5,8,30,22,1,840,142,1139,0.048289999961853,130,0,4.33430338507097,3.8647067089322,128.276595100416,845.602932314147,154
"388",2021-03-23,16666,1025,460,112,85.4,128,2,2,123,4,9,30,21,1,844,125,1963,0.0341300010681152,152,0,3.16771593837873,3.8416557124674,114.310909882542,920.949461036848,130
"389",2021-03-24,16784,1079,460,93,87.6,118,2,4,108,4,9,31,22,0,848,110,3093,0.0426800012588501,47,0,4.20411604756762,4.00854217905411,99.1802246735413,933.631476570465,120
"390",2021-03-25,16942,1166,461,126,96.6,158,1,5,148,7,10,37,27,1,855,149,2986,0.0341599988937378,281,0,3.12218416580046,4.02135842006403,139.092012351968,1049.33749263352,163
"391",2021-03-26,17073,1239,462,114,96,131,5,2,119,4,11,39,28,1,859,124,2371,0.0598899984359741,117,0,5.70736279307454,4.27859736263989,103.320608196768,1012.38898028868,137
"392",2021-03-27,17207,1318,464,140,104.1,134,1,4,127,5,13,41,28,2,864,128,2456,0.0565999984741211,117,0,5.40262713767747,4.31863926228307,109.839007622683,1089.81103161482,143
"393",2021-03-28,17300,1347,465,137,111.1,93,3,3,84,5,13,42,29,1,869,87,2473,0.0792600011825561,156,0,7.4556859233344,4.77057077012917,69.2135130811379,1025.16784046313,102
"394",2021-03-29,17441,1441,465,130,121.7,141,0,2,136,4,12,43,31,0,873,136,1628,0.0761700010299683,40,0,7.43433823002328,5.21343289083664,105.599220168641,1097.6946784045,154
"395",2021-03-30,17609,1537,466,176,130.9,168,1,7,159,5,13,44,31,1,878,160,1967,0.0457499980926514,64,0,4.43083437952955,5.39387838242962,144.281495555855,1318.76036668343,175
"396",2021-03-31,17818,1647,466,180,143.3,209,1,1,204,7,15,49,34,0,885,205,2905,0.0667799997329712,205,0,6.23781026444634,5.68440612769801,165.021103369659,1317.76954756014,212
"397",2021-04-01,17975,1725,467,206,154.7,157,0,1,156,2,15,46,31,1,887,156,1252,0.0726800012588501,88,0,6.79069862508062,6.20847962188089,123.052070313132,1349.61423903945,181
"398",2021-04-02,18020,1696,467,243,173.1,45,0,0,45,2,16,47,31,0,889,45,NA,NA,NA,NA,NA,NA,NA,NA,170
"399",2021-04-03,18023,1641,467,102,167.7,3,0,0,3,0,16,47,31,0,889,3,NA,NA,NA,NA,NA,NA,NA,NA,170
